no te rindas;rendir:v , aún estás;estar:v a tiempo;*:n	ani reñeme'ẽ;me'ẽ:v , ikatu;katu:v gueterei
de alcanzar;*:v … y comenzar;*:v de nuevo;*:a|*:n ,	rehupyty;<hupyty:v … ha reñepyrũjey;pyrũ:v|ñepyrũ:v ,
aceptar;*:v tus sombras;sombra:n ,	emoneívo iñipytũva nde;*|*:n rekópe;<heko:n ,
enterrar;*:v tus miedos;miedo:n ,	eñotỹvo;ñotỹ:v (vo) umi ndekyhyjeha;kyhyje:v ,
liberar;*:v el lastre;*:n|lastrar:v ,	epoívo;poi:v (vo) mba'epohýigui ,
retomar el vuelo;volar:v|*:n .	revevejeývo;veve:v (vo) .
no te rindas;rendir:v que la vida;*:n es;ser:v eso ,	ani reñeme'ẽ;me'ẽ:v péva;*|pe:n|*:n hína pe;*|*:n ñanemoingovéva;moingo:v ,
continuar el viaje;viajar:v|*:n ,	embojoapy;mbojoapy:v nde;*|*:n guata;*:n ,
perseguir;*:v tus sueños;sueño:n ,	ani rehejarei;<heja:v nde;*|*:n kerayvoty;*:n ,
destrabar el tiempo;*:n ,	emosãso ára;*:n ,
correr;*:v los escombros;escombro:n ,	emboyke;mboyke:v kusugue;*:n
y destapar;*:v el cielo;*:n .	ha eipe'a;pe'a:v arapy;*:n rokẽ;<hokẽ:n .
no te rindas;rendir:v , por favor;*:n , no cedas;ceder:v ,	ani reñeme'ẽ;me'ẽ:v , ani nekangy;kangy:v ,
aunque el frío;freír:v|*:a|*:n queme;quemar:v ,	jepémo ro'y;*:n nderapy;<hapy:v ,
aunque el miedo;*:n muerda;morder:v ,	jepémo kyhyje;*:n ndesu'urasy ,
aunque el sol;*:n se esconda;esconder:v ,	jepémo kuarahy;*:n oñemi;ñemi:v ,
y se calle;callar:v|*:n el viento;*:n ,	jepémo yvytu;*:n okirirĩ;kirirĩ:v ,
aún hay fuego;*:n en tu alma;*:n	oígui gueterei tata;<hata:n ne;nde:n ángape;ánga:n
aún hay vida;*:n en tus sueños;sueño:n .	oĩgui;ĩ:v gueterei pytuhẽ;*:n nde;*|*:n kerayvotýpe;kerayvoty:n .
porque la vida;*:n es;ser:v tuya y tuyo también el deseo;*:n|desear:v	tekove;<heko:n|<hekove:n ha'égui;'e:v nemba'e ha nemba'égui avei tembipota;<hembipota:n
porque lo has;haber:v querido;*:a|*:n|querer:v y porque yo te quiero;querer:v	ndentevoi reipotágui;pota:v ha che;*|*:n rohayhúgui;<hayhu:v
porque existe;existir:v el vino;venir:v|*:n y el amor;*:n , es;ser:v cierto;*:a .	oĩgui;ĩ:v yvaũrykue ha mborayhu;*:n , añetehápe;*|añete:n .
porque no hay heridas;herir:v|herida:n que no cure;curar:v el tiempo;*:n .	ndaipórigui pere;pe:n|*:n ára;*:n omonguera'ỹva;monguera:v .
abrir;*:v las puertas;puerta:n ,	eipe'a;pe'a:v okẽ ,
quitar;*:v los cerrojos;cerrojo:n ,	ehekýi;<hekýi:v mba'embotyha ,
abandonar;*:v las murallas;muralla:n que te protegieron;proteger:v ,	eheja;<heja:v ogapy neñongatuva'ekue;ñongatu:v ,
vivir;*:n|*:v la vida;*:n y aceptar;*:v el reto;retar:v|*:n ,	emoingo;moingo:v nde;*|*:n reko;<heko:n ha embohovake apañuãi ,
recuperar;*:v la risa;*:n ,	eñemomba'ejey;momba'e:v pukáre;puka:n ,
ensayar;*:v un;*:a canto;*:n|cantar:v ,	eñeha'ã;ha'ã:v|ñeha'ã:v ha epurahéi;purahéi:v ,
bajar;*:v la guardia;*:n y extender;*:v las manos;mano:n	emboguejy;guejy:v|mboguejy:v nde;*|*:n jyva;*:n oñorairõséva;ñorairõ:v ha eipyso;pyso:v nde;*|*:n po;*|*:n
desplegar;*:v las alas;ala:n	embosako'i;mbosako'i:v nde;*|*:n pepo;*:n|po:v
e intentar;*:v de nuevo;*:a|*:n ,	ha eñeha'ãjey;ha'ã:v|ñeha'ã:v ,
celebrar;*:v la vida;*:n y retomar los cielos;cielo:n .	egueroayvu;ayvu:v nde;*|*:n rekove;<heko:n|<hekove:n ha eñemomba'e;momba'e:v arapýre;arapy:n .
no te rindas;rendir:v , por favor;*:n , no cedas;ceder:v ,	ani reñeme'ẽ;me'ẽ:v , ani nekangy;kangy:v ,
aunque el frío;freír:v|*:a|*:n queme;quemar:v ,	jepémo ro'y;*:n nderapy;<hapy:v
aunque el miedo;*:n muerda;morder:v ,	jepémo kyhyje;*:n ndesu'urasy ,
aunque el sol;*:n se ponga;poner:v y se calle;callar:v|*:n el viento;*:n ,	jepémo kuarahy;*:n oñemi;ñemi:v ha yvytu;*:n okirirĩ;kirirĩ:v ,
aún hay fuego;*:n en tu alma;*:n ,	oĩgui;ĩ:v gueterei tata;<hata:n ne;nde:n ángape;ánga:n ,
aún hay vida;*:n en tus sueños;sueño:n	oĩgui;ĩ:v gueterei pytuhẽ;*:n nde;*|*:n kerayvotýpe;kerayvoty:n
porque cada día;*:n es;ser:v un;*:a comienzo;comenzar:v|*:n nuevo;*:a|*:n ,	ára;*:n pyahu he'iségui;'e:v|he'ise:n ñepyrũjey ,
porque esta es;ser:v la hora;*:n y el mejor;*:a momento;*:n .	ko'áĝa ha'égui;'e:v pe;*|*:n aravoite .
porque no estás;estar:v solo;*|*:a|*:n , porque yo te quiero;querer:v …	nereiméigui;ime:v ne;nde:n año ha che;*|*:n rohayhúgui;<hayhu:v …
mario Benedetti nació;nacer:v en Paso de los Toros , Takuarembo , República Oriental del Uruguay el día;*:n 14 de setiembre;*:n del año;*:n 1920; y falleció;fallecer:v en la Ciudad de Montevideo , Uruguay , el día;*:n 17 de mayo;*:n del año;*:n 2009.	mario Benedetti niko heñóikuri Paso de los Toros , Takuarembo ; Uruguay;uruguay:n retãme;<hetã:n , ára;*:n 14 jasyporundy;*:n ary;*:n 1920- pe;*|*:n ; ha omanókuri;mano+kuri:v|mano:v Táva Montevideo , Uruguay;uruguay:n retãme;<hetã:n , ára;*:n 17 jasypo;*:n ary;*:n 2009- pe;*|*:n .
la Ciudad de Kapiata fue;ir:v|ser:v fundada;fundar:v por el Gobernador Martín Ledesma de Balderrama en el año;*:n 1640, el día;*:n 2 de febrero;*:n , Día de la Virgen de la Candelaria ; sin embargo;*:n|embargar:v , el Prof . Esteban Antonio Romero , historiador;*:n capiateño asegura;asegurar:v que la ciudad;*:n fue;ir:v|ser:v fundada;fundar:v por Pedro Lugo de Navarro , ya que según dicho;*:n|decir:v investigador;*:n , en esa época;*:n Don Pedro Lugo de Navarro era;*:n|ser:v gobernador;*:n ya que Martín Ledesma de Balderrama en ese año;*:n se encontraba;encontrar:v en España .	táva;*:n Kapi'atã niko omoheñoiva'ekue;<heñói:v Sãmbyhyhára Martín Ledesma de Balderrama ary;*:n 1640- pe;*|*:n , ára;*:n 2 jasykõime , Tupãsy La Candelaria árape;ára:n ; upéicharõ;upe:n|upe+rõ:s jepe;*|pe:n , Mbo'ehára Esteban Antonio Romero , tembiasakuaahára kapi'atãygua , he'i;'e:v ko táva;*:n omoheñoihague;<heñói:v Pedro Lugo de Navarro , kóva;*|*:n ha'égui;'e:v upérõ;upe:n|upe+rõ:s sãmbyhyhára;sãmbyhy:n ha ndaje upe;*|*:n arýpe;ary:n Martín Ledesma de Balderrama oĩhaguére;ĩ:v España - pe;*|*:n .
de cualquier manera;*:n , Kapiata es;ser:v una;uno:n|un:a|unir:v de las ciudades;ciudad:n más antiguas;antiguo:a del Paraguay .	taha'eha'eháicha , Kapi'atã niko oĩ;ĩ:v umi ñane;ñande:n retã;<hetã:n táva;*:n itujavéva;tuja:v apytépe;*|apyte:n .
la palabra;*:n Kapiata procede;proceder:v de las voces;voz:n guarani;*:n “ Kapi'i ” que es;ser:v una;uno:n|un:a|unir:v “ paja;*:n ” y “ atã” que significa;significar:v “ duro;durar:v|*:a|*:n / a ”.	ñe'ẽ;*:n Kapiata ou;ju:v mokõi;*:n ñe'ẽgui;ñe'ẽ:n : “ kapi'i;*:n ” ha “ atã ”.
es;ser:v decir;*:v , “ Kapi'i'atã” quiere;querer:v decir;*:v o designa;designar:v una;uno:n|un:a|unir:v “ variedad;*:n de paja;*:n ” que tiene;tener:v la característica;*:n de ser;*:n|*:v “ dura;durar:v|duro:a ”; usada;usar:v|usado:a para la confección;*:n de las escobas , actividad;*:n artesanal;*:a característica;*:n de los capiateños .	ja'eporãtarõ , ñambohyapuva'erã “ Kapi'i'atã ”; ha'éva;'e:v|ha'e:n peteĩ;*:n ka'avo;*:n hetava'ekue;<heta:v ko táva;*:n oĩhame ha ijere;jere:n rupi;*|<hupi:n avei ha ichugui;ha'e:n ojejapo;<japo:v avei typycha;*:n ha'éva;'e:v|ha'e:n Kapi'atãygua rembiapo;<hembiapo:n teete .
el Distrito de Kapiata se halla;hallar:v ubicado;ubicar:v en el Departamento Central .	táva;*:n Kapi'atã oĩ;ĩ:v Tetãpehẽ Central - pe;*|*:n .
kapiata está;estar:v dividida;dividir:v en un;*:a Centro Urbano con 11 barrios;barrio:n y 15 compañías;compañía:n .	kapi'atã oñemboja'o;mboja'o:v peteĩ;*:n Tavaitépe orekóva;ko:v 11 Jeikoha y;*:n 15 Tavapehẽ .
kapiata cuenta;contar:v|*:n con una;uno:n|un:a|unir:v población;*:n de 250.000 habitantes;habitante:n .	ko távape;táva:n oiko;ko:v|iko:v 250.000 tekove;<heko:n|<hekove:n .
la superficie;*:n de la Ciudad es;ser:v de 83 km2.	kapi'atã yvy;*:n ojepyso;pyso:v 83 km2.
tiene;tener:v límites;límite:n con siete;*:a|*:n ciudades;ciudad:n : Luque , Areguá , Itauguá , J . Augusto Saldívar , Ypané , Ñemby y San Lorenzo .	kapi'atã rembe'ýpe;<hembe'y:n oĩ;ĩ:v pokõi táva;*:n : Luque , Aregua , Itaugua , J . Augusto Saldívar , Ypane , Ñemby ha San Lorenzo .
la Municipalidad de Kapiata está;estar:v asentada;asentar:v en el Barrio San Roque sobre;*|sobrar:v|*:n la ruta;*:n Mcal . Estigarribia y Mcal . López .	kapi'atã Tavao oñemohenda;mohenda:v|ñemohenda:v Jeikoha San Roque - pe;*|*:n , tape;<hape:n Mcal . Estigarribia ha Mcal . López ári , Km 20.
kapiata nace;nacer:v como;*|comer:v ciudad;*:n el día;*:n 20 de mayo;*:n del año;*:n 1872 con la creación;*:n de la Primera Junta Municipal .	kapi'atãgui oiko;ko:v|iko:v táva;*:n ára;*:n 20 jasypa;*:n ary;*:n 1872- pe;*|*:n oñemoheñoirõguare Tavao Aty Peteĩha .
finalmente , en el año;*:n 1968 fue;ir:v|ser:v elevada;elevado:a|elevar:v a municipio;*:n y tuvo;tener:v su primer;primero:a intendente municipal;*:n .	ipahápe;*|pa:n|paha:n , ary;*:n 1968- pe;*|*:n ojehechakuaa;<hecha:v ichupe;ha'e:n tavaóramo ha upe;*|*:n guive oguereko;reko:v táva;*:n motenondehára .
en una;uno:n|un:a|unir:v Nochebuena a minutos;minuto:n de la Navidad un;*:a anciano;*:a|*:n medita;meditar:v solitariamente , junto;juntar:v|*:a a la ventana;*:n de su aposento;*:n|aposentar:v ; con mirada;*:n|mirar:v angustiada;angustiar:v mira;*:n|mirar:v el cielo;*:n impasible , brillante;*:a , lleno;llenar:v|*:a|*:n de estrellas;estrella:n , y la tierra;*:n silenciosa;silencioso:a , envuelta;envuelto:a|envolver:v por el suave;*:a viento;*:n .	peteĩ;*:n Pyharemarangatúpe Arareñóimboyvemi , peteĩ;*:n karai;*:n tujamioñepy'amongeta ha'eñomi , ovetã;*:n ykére;*|yke:n , ikotykehápe ; omaña;maña:v kyhyje;*:n yvágare;yvága:n heko;<heko:n kirirĩ guasúva;guasu:n , ojajáiva;jajái:v , henyhẽva;<henyhẽ:v mbyjakuéragui;mbyja:n , ha yvy;*:n ape;*:n katu ikirirĩ ha oñeañuã yvytu;*:n kangy piro'ýpe .
no hay en este;*:n mundo;*:n un;*:a corazón;*:n tan árido como;*|comer:v el suyo ni un;*:a alma;*:n tan atribulada;atribular:v .	ndaipóringo ko yvy;*:n ape;*:n ári peteĩ;*:n korasõ;*:n inandivéva;nandi:v imba'évagui;mba'e:n ha peteĩ;*:n ánga;*:n ikatuva'erã;katu:v oñembyasyve;ñembyasy:v ichugui;ha'e:n .
el sepulcro;*:n se abre;abrir:v ya ante;*|*:n sus pasos;paso:n ; él se encamina;encaminar:v a la sima;*:n y nota;notar:v|*:n asustado;asustar:v , que por bagaje de su vida;*:n , no trae;traer:v más que un;*:a enjambre de errores;error:n ; un;*:a cuerpo;*:n quebrantado;quebrantar:v por las enfermedades;enfermedad:n y un;*:a alma;*:n envenenada;envenenar:v .	tyvyty;*:n niko ojepe'áma;pe'a:v ohóvo;ha:v (vo) henonderãme ; ha'e;*|'e:v|*:n ohupytypotáma hembe'y;<hembe'y:n ha ñemondýi;mondýi:n|*:n reheve ohechakuaa;<hecha:v hekove;<heko:n|<hekove:n rapykuere;<hapykue:n henyhẽha;<henyhẽ:v|<henyhẽ:n opaichagua;opa:n jejavygui ; hete;<hete:n katu hasykatupaite;<hasy:v ha hi'ánga;ánga:n hekotyaipa .
como;*|comer:v espectros;espectro:n aterradores;aterrador:a se arremolinan;arremolinar:v en su memoria;*:n los días;día:n hermosos;hermoso:a de la juventud;*:n : aquella espléndida;espléndido:a mañana;*:n de mayo;*:n en que su padre;*:n le puso;poner:v por primera;primero:a|*:n vez;*:n en el sendero;*:n de la vida;*:n desconocida;desconocido:a|desconocer:v para él ; asimismo , aquel momento;*:n fatal;*:a , en que él , el joven;*:a|*:n de sonrientes;sonriente:a esperanzas;esperanza:n , pisó;pisar:v , en vez;*:n del camino;*:n|caminar:v pedregoso , pero;*|*:n apacible , de la virtud;*:n ; aquel otro;*:a|*:n de la voluptuosidad y del error;*:n ; camino;*:n|caminar:v que le prometía;prometer:v el gozo;*:n|gozar:v , pero;*|*:n lo precipitó;precipitar:v arteramente al abismo;*:n .	póra;*:n ivaivaivévaicha;vai+vaicha:v|vai:v ohasa;<hasa:v iñakã;akã:n rupi;*|<hupi:n umi ára;*:n porãite;po:n imitãrusúrõguare : ku jasypo;*:n pyhareve;py:n|pyhare:n|*:n jajai'asy itúva;ru:n opoírõguare;poi:v (ramo+guare) chugui;ha'e:n oguata;guata:v haĝua ha'eño ha ijehegui ko yvy;*:n ape;*:n ári , teko;<heko:n ha'e;*|'e:v|*:n ne'irã oikuaaguasúva;kuaa:v gueterei ; upéicha;upe:n avei , ku pa'ũ;*:n hekojetu'úva , ha'e;*|'e:v|*:n , mitãrusu;*:n henyhẽva;<henyhẽ:v pukavy;*:n ha kerayvotyeta porãgui;po:n , opyrũrãngue;pyrũ:v tape;<hape:n hasyvéva;<hasy:v , py'aguapy;*:n me'ẽha;me'ẽ:n , tekokatu rape;<hape:n ; oguatákuri;guata+kuri:v|guata:v ambuére;ambue:n henyhẽva;<henyhẽ:v tekojerovu ha jejavýgui ; tape;<hape:n gua'u omyenyhẽtava heko;<heko:n vy'águi;vy'a:n ha upevérõ;upe:n|upe+rõ:s pya'eterei;pya'e:n ombosyryrýva;syryry:v chupe;ha'e:n yvykua gotyo .
una;uno:n|un:a|unir:v pena;*:n|penar:v indecible tortura;torturar:v|*:n el corazón;*:n del anciano;*:a|*:n , cuando grita;gritar:v sollozando;sollozar:v en el silencio;silenciar:v|*:n de la noche;*:n : ¡ Si pudieran;poder:v volver;*:v otra;otro:n|otro:a vez;*:n los años;año:n de la juventud;*:n !.	peteĩ;*:n py'arasy;*:n ijapyra'ỹva ohapy;<hapy:v pe;*|*:n karai;*:n tujami korasõ;*:n , omohasẽ;<hasẽ:v chupe;ha'e:n ha sapukái;*:n upe;*|*:n pyhare;py:n|*:n ikirirĩ'asývape : ¡ Ikatúnga'ura'e ambojevy ára;*:n ha aikojey;ko:v|iko:v mitãrusúrõ;mitãrusu+rõ:s|mitãrusu:n !.
¡ Oh , Padre mío , colócame otra;otro:n|otro:a vez;*:n en el cruce;*:n|cruzar:v de los caminos;camino:n de la vida;*:n , para que pueda;poder:v elegir;*:v de otro;*:a|*:n modo;*:n !.	¡ Oo , che;*|*:n Ru , chemoĩjeýna tapejoasahápe aiporavo;poravo:v haĝua ambue;*:n tape;<hape:n !.
la queja;quejar:v|*:n sollozante del anciano;*:a|*:n se pierde;perder:v sin respuesta;*:n en el silencio;silenciar:v|*:n de noche;*:n .	karai;*:n tujami py'arasy;*:n oñemondéva;monde:v|ñemonde:v tasẽme;<hasẽ:n oho;ha:v ha okañy;kañy:v upe;*|*:n pyhare;py:n|*:n kirirĩguasúpe ha ndohupytýi;<hupyty:v ñembohovái;mbohovái:n .
no tendrá;tener:v ya ocasión;*:n de elegir;*:v ...	ndorekomo'ãvéima pa'ũ;*:n oiporavo;poravo:v haĝua …
pero;*|*:n tú , amigo;*:n mío , estás;estar:v todavía frente;*:n al cruce;*:n|cruzar:v de los caminos;camino:n de la vida;*:n .	áĝakatu nde;*|*:n , che;*|*:n irũ;*:n , reime;ime:v gueterei tapejoasaha renondépe;*|<henonde:n .
tu puedes elegir;*:v aún el camino;*:n|caminar:v recto;regir:v|*:a|*:n .	nde;*|*:n reiporavokuaa;poravo:v gueterei tape;<hape:n ikare'ỹva .
no seas;ser:v primavera;*:n , sin flores;flor:n ... No seas;ser:v cielo;*:n , sin estrellas;estrella:n ... No seas;ser:v una;uno:n|un:a|unir:v persona;*:n , sin nobles;noble:n|noble:a ideales;idear+les:v|ideal:n ...	aníke oiko;ko:v|iko:v ndehegui;nde:n arapoty;*:n ijyvoty'ỹva … Aníke oiko;ko:v|iko:v ndehegui;nde:n yvága;*:n imbyja'ỹva;mbyja:n … Aníke oiko;ko:v|iko:v ndehegui;nde:n tekove;<heko:n|<hekove:n hekokatu'ỹva …
en Ka'apuku , hace;hacer:v muchos;mucho:a años;año:n , vivía;vivir:v un;*:a niño;*:n llamado;llamar:v|*:a Carlitos junto;juntar:v|*:a a sus padres;padre:n .	ka'apukúpe , yma ymaite , oikova'ekue;ko:v|iko:v peteĩ;*:n mitã'i;mitã:n|*:n hérava;<héra:n|<héra:v Kalo'i;kalo:n itúva;ru:n ha isy;sy:n ndive .
ellos vivían;vivir:v en un;*:a humilde;*:a ranchito;*:n y eran;ser:v muy pero;*|*:n muy pobres;pobre:a|pobre:n .	ha'ekuéra;*|ha'e:n oikova'ekue;ko:v|iko:v peteĩ;*:n tapỹi;*:n chu'imíme ha imboriahu;mboriahu:v imboriahueterei hikuái .
su padre;*:n labraba;labrar:v la tierra;*:n que le producía;producir:v maíz;*:n , zapallo;*:n , maní;*:n , batata;*:n , mandioca;*:n y poroto;*:n .	itúva;ru:n oñembokokue ha yvy;*:n ome'ẽ;me'ẽ:v chupe;ha'e:n avati;*:n , kurapepẽ , manduvi;*:n , jety;<hy:n|*:n , mandi'o;*:n ha kumanda;*:n .
en época;*:n de carestía;*:n se alimentaban;alimentar:v de lo poco;*:a|*:n que lograban;lograr:v juntar;*:v y muchas;mucho:a veces;vez:n hasta pasaron;pasar:v hambre;*:n por carecer;*:v de comida;comer:v|*:n .	opávo;pa+vo:v|opa:n|opa+vo:s umíva ho'umiva'erã;'u:v umi tembyremi ombyatyva'ekue;mbyaty:v ha heta;<heta:v jey;jevy:n|y:n ohasa;<hasa:v hikuái ñembyahýi ndorekovéigui tembi'u;<hembi'u:n .
su abuelo;*:n siempre le decía;decir:v a Carlitos que luego de morir;*:v él vería;ver:v , con Dios , como;*|comer:v ayudarlos;ayudar:v (los) para salir;*:v de la pobreza;*:n ; y así;*|asir:v , un;*:a día;*:n , el abuelo;*:n falleció;fallecer:v .	hamói;<hamói:n he'imiva'erã;'e:v Kalo'ípe;kalo:n omano;mano:v rire ohechataha , Ñande Ru ndive , mba'éichapa;*|mba'e:n ikatúne;katu:v oipytyvõ;pytyvõ:v chupekuéra;ha'e:n osẽ;sẽ:v haĝua mboriahúgui ; ha péicha;*|pe:n , peteĩ;*:n ára;*:n , tamói;<hamói:n omano;mano:v .
días;día:n después el abuelo;*:n se le apareció;aparecer:v en sueños;sueño:n a Carlitos y le dijo;decir:v : “ Fíjate , después de la primera;primero:a|*:n lluvia;*:n , donde nace;nacer:v el arcoíris y allí encontrarás;encontrar:v una;uno:n|un:a|unir:v gran;grande:a riqueza;*:n que - bien;*|*:a|*:n administrada;administrar:v por ustedes - les ayudará;ayudar:v a vivir;*:n|*:v holgadamente ”.	ohasávo;<hasa:v (vo) umi ára;*:n , tamói;<hamói:n ojehechauka;<hecha:v|<hechauka:v Kalo'ípe;kalo:n iképe ha he'i;'e:v chupe;ha'e:n : “ Ejesareko , ama;*:n guasu;*:n oúva;ju:v rire , pe;*|*:n jýi;*:n heñoihápe ha upépe;upe:n rejuhúta;juhu:v mba'eta guasu;*:n peneipytyvõtava - peipuruporãrõ - peiko;ko:v|iko:v porã;po:n haĝua peikotevẽ'ỹre;kotevẽ:v mba'eve;mba'e:n ”.
y efectivamente , Carlitos y su padre;*:n , luego de la lluvia;*:n , fueron;ir:v|ser:v hasta donde nacía;nacer:v el arcoíris y encontraron;encontrar:v una;uno:n|un:a|unir:v olla;*:n llena;lleno:a|llenar:v de oro;orar:v|*:n .	ha añetehápe;*|añete:n , Kalo'i;kalo:n ha itúva;ru:n , ama;*:n guasu;*:n rire , ohókuri;ha:v|ha+kuri:v jýi;*:n heñoiha peve;*|pe:n ha ojuhu;juhu:v peteĩ;*:n japepo;*:n henyhẽva;<henyhẽ:v itajúgui;itaju:n .
esa riqueza;*:n los ayudó;ayudar:v a vivir;*:n|*:v muy bien;*|*:a|*:n y a ayudar;*:v a sus semejantes .	pe;*|*:n mba'eta rupive;<hupi:n ha'ekuéra;*|ha'e:n ohupyty;<hupyty:v tekoporã;<hekoporã:n ha avei oipytyvõ;pytyvõ:v hapichakuéra;<hapicha:n oikotevẽvape .
y así;*|asir:v llega;llegar:v a su fin;*:n la historia;*:n de Carlitos que ayudado;ayudar:v por su abuelo;*:n encontró;encontrar:v la riqueza;*:n donde nacía;nacer:v el arcoíris …	ha péicha;*|pe:n oĝuahẽ;guahẽ:v ijapýpe;ja:n|apy:n Kalo'i;kalo:n rembihasakue , hamói;<hamói:n ñepytyvõ;pytyvõ:n|*:n rupive;<hupi:n , ojuhuva'ekue;juhu:v mba'eta oĩva;ĩ:v jýi;*:n heñoihápe …
josé Hernández , cuyo nombre;*:n|nombrar:v completo;completar:v|*:a|*:n es;ser:v José Rafael Hernández y Pueyrredón , nació;nacer:v el día;*:n 10 de noviembre;*:n del año;*:n 1834, en Buenos Aires , República Argentina .	josé Hernández , héra;<héra:n|<héra:v pukuvéva José Rafael Hernández y;*:n Pueyrredón , heñóikuri ára;*:n 10 jasypateĩ;*:n ary;*:n 1834- pe;*|*:n , Táva Buenos Aires , Argentina retãme;<hetã:n .
su padre;*:n fue;ir:v|ser:v Rafael Hernández y su madre;*:n Isabel de Pueyrredón .	itúva;ru:n herava'ekue;<héra:v Rafael Hernández ha isýkatu;sy:n Isabel de Pueyrredón .
fue;ir:v|ser:v militar;*:n|*:v , periodista;*:n , poeta;*:n y político;*:n argentino;*:a|*:n , más conocido;conocer:v|*:a|*:n como;*|comer:v el autor;*:n del Martín Fierro , obra;*:n|obrar:v máxima;*:n de la literatura;*:n gauchesca .	guarini;*:n , marandu'asãihára , ñe'ẽpapára;*:n ha teikuaihára Argentina - ygua;y:n|*:n , ojekuaavéva;jekuaa:v|kuaa:v ohaihaguére;hai:v Martín Fierro , aranduka ojehecharamovéva;<hecha:v gaucho reko;<heko:n rehegua .
en su homenaje;*:n , el 10 de noviembre;*:n - aniversario;*:n de su nacimiento;*:n - se celebra;celebrar:v el Día de la Tradición en la República Argentina .	hérape;<héra:n|<héra:v , ára;*:n 10 jasypateĩ;*:n jave;*|ja:n - hi'arambotýpe - ojegueromandu'a Tavarandu Ára Argentina retãme;<hetã:n .
iniciado;iniciar:v como;*|comer:v militar;*:n|*:v en defensa;*:n de la autonomía;*:n del Estado de Buenos Aires , entre;*|entrar:v los años;año:n 1852 y 1872 desarrolló;desarrollar:v una;uno:n|un:a|unir:v fuerte;*:a|*:n actividad;*:n periodística .	oikókuri;iko+kuri:v|ko:v|ko+kuri:v|iko:v chugui;ha'e:n guarini;*:n oipysyrõnguévo Buenos Aires rekosãso , ary;*:n 1852 guive 1872 peve;*|pe:n omba'apo;mba'apo:v mbarete;*:n marandu'asãihápe .
en esa época;*:n caliente;calentar:v|*:a políticamente , decía;decir:v que las Provincias no debían;deber:v permanecer;*:v ligadas;ligar:v|ligado:a al gobierno;gobernar:v|*:n de Buenos Aires .	“ Yvy hakuve;<haku:n|<haku:v jave;*|ja:n ”, he'íkuri;'e+kuri:v|'e:v Tetãpehẽnguéra natekotevẽiha oĩ;ĩ:v Buenos Aires ruvicha;<huvicha:n poguýpe;guy:v .
desde el año;*:n 1857 se radicó;radicar:v en Parana y vivió;vivir:v alternativamente en esa ciudad;*:n , en Corrientes , Rosario y Montevideo para después retornar;*:v a Buenos Aires .	ary;*:n 1857- pe;*|*:n ova;va:v ha oikókuri;iko+kuri:v|ko:v|ko+kuri:v|iko:v Paranáme;parana:n ha upégui;upe:n ova;va:v Corrientes , Rosario ha Montevideo - pe;*|*:n ha upéi ojevy Buenos Aires - pe;*|*:n .
participó;participar:v en una;uno:n|un:a|unir:v de las últimas;último:a rebeliones;rebelión:n federales;federal:a|federar+les:v , dirigida;dirigir:v por Ricardo López Jordán , cuyo intento;*:n|intentar:v de acción;*:n finalizó;finalizar:v en el año;*:n 1871 con la derrota;*:n|derrotar:v de los gauchos y el exilio;exiliar:v|*:n de José Hernández en el Brasil .	oĩjepékuri;ĩ:v|ĩ+kuri:v umi Federal ñorãirõ;ñorairõ:n pahápe;pa:n|paha:n , omoakãva'ekue Ricardo López Jordán , ndaipu'akáiva'ekue;pu'aka:v hovaiguáre ha oguevi;guevi:v ary;*:n 1871- pe;*|*:n guaucho - kuéra oñeme'ẽhaguépe;me'ẽ:v ha José Hernández katu oñemomombyry;ñemomombyry:v ha oho;ha:v Brasil retãme;<hetã:n .
después de esta revolución;*:n él siguió;seguir:v colaborando;colaborar:v con López Jordán , de quién con el tiempo;*:n se separó;separar:v .	upe;*|*:n ñorairõ;*:n rire ha'e;*|'e:v|*:n oipytyvõvékuri;pytyvõ:v|pytyvõ+kuri:v López Jordán - pe;*|*:n ha mbeguekatúpe ojeheja;<heja:v chugui;ha'e:n .
a su retorno;*:n|retornar:v a la Argentina , en el año;*:n 1872, continuó;continuar:v su lucha;*:n|luchar:v por medio;*:a|*:n|mediar:v del periodismo;*:n y publicó;publicar:v la primera;primero:a|*:n parte;partir:v|*:n de su obra;*:n|obrar:v maestra;*:n , El Gaucho Martín Fierro .	ojevývo Argentina - pe;*|*:n , ary;*:n 1872- pe;*|*:n , ombojoapy;mbojoapy:v iñorairõ;ñorairõ:n marandu'asãi rupive;<hupi:n ha upérõ;upe:n|upe+rõ:s ohecha;<hecha:v ára;*:n resa;<hesa:n hembiapo;<hembiapo:n tuichavéva , El Gaucho Martín Fierro .
fue;ir:v|ser:v a través;*:n de su poesía;*:n como;*|comer:v consiguió;conseguir:v un;*:a gran;grande:a eco;*:n para sus propuestas;proponer:v|propuesta:n y la más valiosa;valioso:a contribución;*:n a la causa;*:n de los gauchos .	iñe'ẽpoty rupive;<hupi:n omyasãimbaretékuri hemiandu;<hemiandu:n ha pytyvõ gaucho - kuéra rayhupápe .
la continuación;*:n de la obra;*:n|obrar:v , La vuelta;volver:v|*:n de Martín Fierro (1879), en conjunto;*:n , forman;formar:v un;*:a poema;*:n épico que refleja;reflejar:v el sentir;*:n|*:v popular;*:a .	upe;*|*:n hembiapo;<hembiapo:n mbojoapypyre;mbojoapy:n , La vuelta de Martín Fierro (1879), ijypykue;ypy:n|jy:n ndive , oñembohete;ñembohete:v|mbohe:v peteĩ;*:n ñe'ẽpoty añóme ha oñanduka tavaygua;*:n remimo'ã .
posteriormente fue;ir:v|ser:v miembro;*:n del Congreso de la Provincia de Buenos Aires con una;uno:n|un:a|unir:v valiosa;valioso:a producción;*:n legislativa;*:a .	uperiréma oike;ke:v Tetãpehẽ Buenos Aires Amandajépe ha upépe;upe:n heta;<heta:v mba'e;*:n porã;po:n ojapókuri;<japo+kuri:v|<japo:v .
josé Hernández falleció;fallecer:v el día;*:n 21 de octubre;*:n de 1886, en Belgrano , Buenos Aires .	josé Hernández omanókuri;mano+kuri:v|mano:v ára;*:n 21 jasypa;*:n ary;*:n 1886- pe;*|*:n , Belgrano , Buenos Aires - pe;*|*:n .
en la espesura;*:n del gran;grande:a monte;montar:v|*:n , una;uno:n|un:a|unir:v noche;*:n , alrededor del fogón , el abuelo;*:n Guarani - como;*|comer:v siempre rodeado;rodear:v de todos;todo:a los niños;niño:n de la aldea;*:n - se disponía;disponer:v a narrarles;narrar:v (les) una;uno:n|un:a|unir:v leyenda;*:n , esta vez;*:n , se trataba;tratar:v de la leyenda;*:n del gran;grande:a guerrero;*:n Urunde .	ka'a;*:n guasu;*:n hypy'ũvéva mbytépe;*|mbyte:n , peteĩ;*:n pyhare;py:n|*:n , tataypýpe;<hataypy:n|<hata:n , tamói;<hamói:n Guarani - oguapýva;guapy:v tata;<hata:n jerére;jere:n opaite;*|opa:n|pa:v mitã'ikuéra;mitã:n|mitã'i:n hekohapegua;<heko:n|<hekoha:n ndive - ohenduka chupekuéra;ha'e:n peteĩ;*:n mombe'upy;mombe'u:n omombe'úva;mombe'u:v guarini;*:n guasu;*:n Urunde rekovekue;<hekove:n .
los Guarani tuvieron;tener:v muchos;mucho:a héroes;héroe:n , valientes;valiente:a guerreros;guerrero:n , líderes;líder:n de sus respectivas comunidades;comunidad:n , y precisamente , Urunde fue;ir:v|ser:v uno;*:n|unir:v de esos hombres;hombre:n .	guaranikuéra niko oguerekojepékuri;reko+kuri:v|reko:v heta;<heta:v tekoverechapyrã , guarini;*:n ha'evéva;'e:v , hekoha;<heko:n|<hekoha:n motenondehára ; ha ja'eporãtarõ , Urunde ha'eva'ekue;'e:v umi rehegua .
el abuelo;*:n Guarani contó;contar:v a los niños;niño:n que Urunde fue;ir:v|ser:v hijo;*:n de Uruguasu , Mburuvicha de una;uno:n|un:a|unir:v gran;grande:a aldea;*:n Guarani asentada;asentar:v en la costa;*:n del Río Paraguay pero;*|*:n en la Región Oriental .	tamói;<hamói:n Guarani omombe'úkuri;mombe'u+kuri:v|mombe'u:v mitãmimíme Urunde ha'ehague;'e:v Uruguasu ñemoñare;ñemoña:n|moña:n|*:n ; Uruguasu niko peteĩ;*:n Guarani Rekoha Guasu Mburuvichakue ; ko tekoha;<heko:n|<hekoha:n guasu;*:n oñemohendava'ekue;mohenda:v|ñemohenda:v Y Paraguay;paraguay:n rembe'ýpe;<hembe'y:n , Arasẽ Yvypehẽme .
urunde fue;ir:v|ser:v criado;*:n|criar:v por su padre;*:n para ser;*:n|*:v un;*:a gran;grande:a líder;*:n , un;*:a gran;grande:a orador;*:n , un;*:a hombre;*:n sabio;*:a|*:n , un;*:a hombre;*:n pleno;*:a|*:n , que - a su muerte;*:n - le sucediera;suceder:v en el gobierno;gobernar:v|*:n de la gran;grande:a aldea;*:n Guarani … y en verdad;*:n , así;*|asir:v ocurrió;ocurrir:v .	uruguasu niko ohekombo'ékuri;<hekombo'e+kuri:v|<hekombo'e:v ita'ýra;ra'y:n Urundépe oiko;ko:v|iko:v haĝua ichugui;ha'e:n peteĩ;*:n motenondehára guasu;*:n , iñe'ẽngatúva , iñarandúva;arandu:n , hekokatúva , omyengoviakuaátava ichupe;ha'e:n - hi'aramano rire - tekoha;<heko:n|<hekoha:n guasu;*:n ñemotenondépe … ha añetehápe;*|añete:n , upeichaite oikókuri;iko+kuri:v|ko:v|ko+kuri:v|iko:v .
un;*:a día;*:n , ya muy entrado;entrar:v en años;año:n , Uruguasu falleció;fallecer:v .	peteĩ;*:n ára;*:n , hetaitereirasa;<heta:v kuarahyresẽ;*:n ohecha;<hecha:v rire , Uruguasu omano;mano:v .
toda;todo:a la aldea;*:n lamentó;lamentar:v la muerte;*:n de ese gran;grande:a hombre;*:n que brindó días;día:n felices;feliz:a a todos;todo:a los miembros;miembro:n de la comunidad;*:n .	tekoha;<heko:n|<hekoha:n tuichaháicha;tuicha:n ombyasy pe;*|*:n karai;*:n guasu;*:n ñemano;mano:n ; ha'éniko;'e:v|ha'e:n|'e+niko:v heta;<heta:v ombovy'apavẽkuri opavavete oikóva;ko:v|iko:v guive upe;*|*:n tekohápe;<heko:n|<hekoha:n .
su hijo;*:n Urunde le confeccionó;confeccionar:v la urna;*:n funeraria;*:n , lo enterró;enterrar:v en compañía;*:n de toda;todo:a la comunidad;*:n , y luego sucedió;suceder:v a su padre;*:n como;*|comer:v Mburuvicha de la gran;grande:a aldea;*:n .	ita'ýra;ra'y:n Urunde niko ojapókuri;<japo+kuri:v|<japo:v ijapeporã , oñotỹkuri;ñotỹ+kuri:v|ñotỹ:v chupe;ha'e:n maymaite ñemoirũ;moirũ:n rupive;<hupi:n ha upehague;upe:n omyengoviákuri itúvape;ru:n ha oiko;ko:v|iko:v ichugui;ha'e:n upe;*|*:n tekoha;<heko:n|<hekoha:n guasu;*:n Mburuvicha .
urunde no se quedó;quedar:v atrás y prosiguió;proseguir:v con las ideas;idea:n de su padre;*:n .	urunde ndopytái;pyta:v tapykuépe;<hapykue:n|tapy:n ha ombojoapyvékuri;mbojoapy:v|mbojoapy+kuri:v itúva;ru:n remimo'ã .
fue;ir:v|ser:v así;*|asir:v que en todo;*:a momento;*:n buscó;buscar:v que su pueblo;poblar:v|*:n transitara;transitar:v por los caminos;camino:n de la justicia;*:n , de la sabiduría;*:n , de la libertad;*:n , herramientas;herramienta:n necesarias;necesario:a para lograr;*:v la vida;*:n plena;pleno:a que finalmente los conduciría;conducir:v a la Tierra sin Mal .	upeichahápe , ára;*:n ha ára;*:n , oñeha'ãkuri;ñeha'ã+kuri:v|ha'ã:v|ha'ã+kuri:v|ñeha'ã:v omboguata;guata:v hetã;<hetã:n tekojoja;<hekojoja:n rape;<hape:n rupi;*|<hupi:n , arandu;*:n rekávo;<heka+vo:s|<heka:n , tekosã'ỹ moañetévo , oikuaaporãgui;kuaa:v umíva ha'eha;'e:v tembipuru oguerahátava chupekuéra;ha'e:n tekokatu repére ohupyty;<hupyty:v peve;*|pe:n Yvy Mara'ỹ .
logró;lograr:v mantener;*:v la tranquilidad;*:n en la gran;grande:a aldea;*:n .	tekoha;<heko:n|<hekoha:n Guasu oiko;ko:v|iko:v tapiaite py'aguapýpe;py'aguapy:n .
así;*|asir:v , mientras las mujeres;mujer:n atendían;atender:v el hogar;*:n , a los hijos;hijo:n y preparaban;preparar:v los alimentos;alimento:n y los tejidos;tejer:v|tejido:n hechos;hecho:n|hacer:v|hecho:a de karanda'y ; Urunde salía;salir:v con varios;vario:a varones;varón:n de la gran;grande:a aldea;*:n a buscar;*:v los productos;producto:n para la subsistencia;*:n : pescados;pescar:v|pescado:n , miel;*:n , frutos;fruto:n , agua;*:n|aguar:v y leña;*:n .	péicha;*|pe:n , kuña;*:n oñangareko;ñangareko:v aja;*|ja:v tapỹi;*:n ha imembykuérare;memby:n ha upekuévo;upe+vo:s|upe:n ojapo;<japo:v aja;*|ja:v tembi'u;<hembi'u:n ha ijaorã karanda'ýgui ; Urunde osẽmiva'erã;sẽ:v heta;<heta:v kuimba'ekuéra;kuimba'e:n ndive ohekávo;<heka:v (vo) hembi'urã : pira;*:n , eirete;*:n , yva;*:n , y;*:n ha jepe'a;*:n|pe'a:n .
a la noche;*:n , la felicidad;*:n de apoderaba;apoderar:v de la gran;grande:a aldea;*:n cuando se reunían;reunir:v en el templo;templar:v|*:n - como;*|comer:v una;uno:n|un:a|unir:v sola;solo:a familia;*:n|familiar:v - a honrar;*:v a Ñande Ru , mediante sus oraciones;oración:n , danzas y cantos;canto:n .	pyharekue;py:n|pyhare:n , vy'apavẽ;*:n oñemomba'e;momba'e:v hesekuéra;ha'e:n ha maymáva ohua'ĩ;hua'ĩ:v oñombyatývo;mbyaty:v (vo) opýpe - oñopehẽnguéicha - omomba'eguasúvo;momba'e+vo:v|momba'eguasu+vo:v Ñande Rúpe , ñembo'e;mbo'e:n jeroky;*:n rupive;<hupi:n .
sin embargo;*:n|embargar:v , de cuando en cuando , eran;ser:v atacados;atacar:v por los temibles indios;indio:n Pajagua , que vivían;vivir:v en la ribera;*:n de enfrente;enfrentar:v ; es;ser:v decir;*:v , en la Región Occidental .	jepémo upéicha;upe:n , sapy'apy'a , ojeitýjepi;ity:v hi'arikuéra;ha'e:n umi Pajagua ñaña;*:n , oikóva;ko:v|iko:v Y Paraguay;paraguay:n mboypýri , Aragua Yvypehẽme .
en esas circunstancias;circunstancia:n , Urunde y sus guerreros;guerrero:n sacaban;sacar:v a relucir;*:v su vocación;*:n guerrera;*:n y en memorables acciones;acción:n|accionar:v siempre lograban;lograr:v expulsar;*:v a los Pajagua de sus tierras;tierra:n , persiguiéndolos;perseguir:v (los) en sus canoas hasta el otro;*:a|*:n lado;*:n del Río Paraguay .	upéicha;upe:n jave;*|ja:n , Urunde ha iguarinikuéra ohechaukájepi;<hecha:v|<hechauka:v ipy'aguasuha;py'aguasu:n|py'aguasu:v ha jetyvyro;tyvyro:n ijojahaỹva rupi;*|<hupi:n akóinte omosẽmiva'erã;sẽ:v Pajaguakuérape hekoha;<heko:n|<hekoha:n guasúgui;guasu:n ha omuñájepi;muña:v chupekuéra;ha'e:n , ygakuérape , Y Paraguay;paraguay:n mboypýri peve;*|pe:n .
grandes;grande:a celebraciones;celebración:n realizaban;realizar:v luego de esas batallas;batalla:n .	umi ñorairõ;*:n rire ojejapómiva'erã vy'arã'aty ndetuichapajepéva .
dicen;decir:v que - entre;*|entrar:v los Guarani - muy pocos;poco:a|poco:n Mburuvicha llegaron;llegar:v a ser;*:n|*:v tan admirados;admirar:v|admirado:a y queridos;querido:n|querido:a|querer:v como;*|comer:v Urunde , un;*:a hombre;*:n incorruptible , fuerte;*:a|*:n , duro;durar:v|*:a|*:n , de estatura;*:n alta;alto:a|*:n , de gran;grande:a resistencia;*:n ; quien gobernó;gobernar:v por varios;vario:a años;año:n a su gran;grande:a aldea;*:n .	oĩ;ĩ:v he'íva;'e:v ndaiporihavoi - Guaranikuéra apytépe;*|apyte:n - peteĩ;*:n Mburuvicha ojehecharamo;<hecha:v ha ojehayhuvéva;<hayhu:v Urundégui , ha'éva;'e:v|ha'e:n peteĩ;*:n kuimba'e;*:n hekotuju'ỹva , imbarete;mbarete:n|mbarete:v , hatã;<hatã:n|<hatã:v , ijyvateporã ha hekoverosã añetetéva ; are;a:n omotenondeva'ekue pe;*|*:n hekoha;<heko:n|<hekoha:n guasúpe;guasu:n .
un;*:a día;*:n , ya muy anciano;*:a|*:n , Ñande Ru convocó;convocar:v al alma;*:n de Urunde a la Tierra sin Mal , lugar;*:n destinado;destinar:v a los seres;ser:n perfectos;perfecto:a .	peteĩ;*:n ára;*:n , itujamímavo;tuja:v (vo) , Ñande Ru ohenói;<henói:v Urundépe ha hi'ãnga ojehekýi;jehekýi:v|<hekýi:v ñande;*|*:n apytégui;apyte:n ha oho;ha:v Yvy Mara'ỹme , ha'éva;'e:v|ha'e:n upe;*|*:n tenda;<henda:n ohupytýva;<hupyty:v umi heko'aguyjéva .
la gran;grande:a aldea;*:n Guarani , con gran;grande:a pesar;*:n|*:v , se encargó;encargar:v de enterrar;*:v su cuerpo;*:n en una;uno:n|un:a|unir:v hermosa;hermoso:a urna;*:n funeraria;*:n , en la costa;*:n del río;reír:v|*:n Paraguay , mirando;mirar:v hacia la Región Occidental como;*|comer:v para atemorizar;*:v por siempre a los temibles indios;indio:n Pajagua , que nunca pudieron;poder:v vencerlo;vencer:v (lo) .	guarani;*:n Tekoha Guasu , tuicha temimbyasýre , oñotỹkuri;ñotỹ+kuri:v|ñotỹ:v hetekue;<hetekue:n|<hete:n peteĩ;*:n japepo;*:n neporãmbajepévape , Y Paraguay;paraguay:n rembe'ýpe;<hembe'y:n , ha omomaña;maña:v hikuái chupe;ha'e:n Aragua Yvypehẽ gotyo akóinte omondýi;mondýi:v haĝua Pajaguakuérape , araka'eve ndaipu'akaiva'ekue;pu'aka:v hese;ha'e:n .
ñande Ru interpretó;interpretar:v el sentimiento;*:n de los miembros;miembro:n de la gran;grande:a aldea;*:n Guarani e hizo;hacer:v crecer;*:v un;*:a nuevo;*:a|*:n árbol;*:n en aquel lugar;*:n , un;*:a árbol;*:n incorruptible , fuerte;*:a|*:n , duro;durar:v|*:a|*:n , de estatura;*:n alta;alto:a|*:n y de gran;grande:a resistencia;*:n ; al cual los Guarani bautizaron Urunde'y , nombre;*:n|nombrar:v de aquel gran;grande:a guerrero;*:n que por mucho;*:a tiempo;*:n los gobernó;gobernar:v .	ñande;*|*:n Ru ohechakuaa;<hecha:v Guarani Rekoha Guasuygua remiandu;<hemiandu:n ha omoheñói;<heñói:v upepete peteĩ;*:n yvyra;*:n pyahu , hekotuju'ỹva , hatã;<hatã:n|<hatã:v , ijyvateporã ha hekoverosã añetetéva ; Guaranikuéra omboherava'ekue;<héra:v upe;*|*:n yvyrápe;yvyra:n : Urunde'y , ohechakuaávo;<hecha:v (vo) pe;*|*:n guarini;*:n guasúpe;guasu:n are;a:n omotenondeva'ekue chupekuéra;ha'e:n .
hasta hoy el Urunde'y es;ser:v un;*:a árbol;*:n muy admirado;admirar:v|*:a y apreciado;apreciar:v|*:a ; y esta es;ser:v la leyenda;*:n de ese hermoso;*:a árbol;*:n .	ko'áĝa peve;*|pe:n Urunde'y ha'e;*|'e:v|*:n yvyra;*:n ojehecharamo;<hecha:v ha ojehayhúva;<hayhu:v ha kóva;*|*:n niko ha'e;*|'e:v|*:n pe;*|*:n mombe'upy;mombe'u:n imandu'áva;mandu'a:n|mandu'a:v pe;*|*:n yvyra;*:n porãitére;po:n .
finalmente , cabe;caber:v mencionar;*:v que la partícula;*:n sufija “ y ” quiere;querer:v decir;*:v “ árbol;*:n o planta;plantar:v|*:n ” por eso aparece;aparecer:v en la denominación;*:n de prácticamente todas;todo:a las variedades;variedad:n forestales ( urunde - y , karanda - y , guapo;*:a - y , kurupa - y , jata - y , juasy - y , amba - y ), y en zonas;zona:n acuáticas;acuático:a la “ y ” sirve;servir:v para indicar;*:v ríos;río:n ( arroyos;arroyo:n o cursos;curso:n de aguas;agua:n ) con abundancia;*:n de determinados;determinar:v peces;pez:n u otras;otro:n|otro:a especies;especiar:v|especie:n y variedades;variedad:n acuáticas;acuático:a ( suruvi - y , pirape - y , jatyta - y , akara - y , javevýi - y ).	ipahápe;*|pa:n|paha:n , tekotevẽ;<hekotevẽ:n ñamyesakã pe;*|*:n ñe'ẽpehẽtai upeigua “ y;*:n ” he'iseha;'e:v|he'ise:n “ yvyra;*:n térã ka'avo;*:n ”, upévare;upe:n omoirũjepi;moirũ:v opavavete nunga yvyra;*:n rerakuérape;<héra:n ( urunde - y;*:n , karanda - y;*:n , guapo - y;*:n , kurupa - y;*:n , jata - y;*:n , juasy - y;*:n , amba - y;*:n ), ha he'õháme katu , pe;*|*:n “ y;*:n ” he'ise;'e:v|*:n “ ysyry;*:n ” hetahápe;<heta:v|<heta:n peteĩchagua;peteĩ:n pira;*:n térã ambue;*:n mymba;*:n oikóva;ko:v|iko:v ýpe;y:n ha y;*:n jere;*:n rupi;*|<hupi:n ( suruvi - y;*:n , pirape - y;*:n , jatyta;*:n - y;*:n , akara - y;*:n , javevýi - y;*:n ).
todos;todo:a estos nombres;nombre:n|nombrar:v son;*:n|ser:v muy antiguos;antiguo:a , corresponden;corresponder:v a la historia;*:n de la América precolombina ; es;ser:v decir;*:v , de antes de 1492.	opaite;*|opa:n|pa:v ko'ã;*|*:n téra;<héra:n niko aretereiguaréma;a:n ; oĩmava'ekuevoi Colón oĝuahẽ;guahẽ:v mboyve Amérikape ; ja'eporãsérõ , ary;*:n 1492 mboyve .
hecho;hacer:v|*:a|*:n ocurrido;ocurrir:v en 1892, verdadero;*:a|*:n , extraído;extraer:v de una;uno:n|un:a|unir:v biografía;*:n .	ko mba'e;*:n ojehúkuri;jehu+kuri:v|jehu:v 1892- pe;*|*:n , añetegua;añete:n|*:n , oñenohẽkuri peteĩ;*:n tekohaipyrégui .
un;*:a señor;*:n de unos;un:a 70 años;año:n viajaba;viajar:v en un;*:a transporte;transportar:v|*:n teniendo;tener:v sentado;sentar:v a su lado;*:n a un;*:a joven;*:a|*:n universitario que leía;leer:v su libro;*:n|librar:v de Ciencias .	peteĩ;*:n karai;*:n orekóva;ko:v 70 ary;*:n rupi;*|<hupi:n ohohína;ha:v peteĩ;*:n mba'yrúpe;mba'yru:n ha ijykére;yke:n oguapy;guapy:v peteĩ;*:n mitãrusu;*:n mbo'ehaovusupegua temimbo'e;<hemimbo'e:n omoñe'ẽva;moñe'ẽ:v|ñe'ẽ:v iñaranduka Tembikuaaty rehegua .
el caballero;*:n también leía;leer:v un;*:a libro;*:n|librar:v de portada;*:n|portar:v negra;negro:a|*:n .	karai;*:n avei omoñe'ẽ;moñe'ẽ:v|ñe'ẽ:v ohóvo;ha:v (vo) peteĩ;*:n aranduka ijapehũva .
fue;ir:v|ser:v cuando el joven;*:a|*:n percibió;percibir:v que se trataba;tratar:v de la Biblia y que estaba;estar:v abierta;abrir:v|abierto:a en el Evangelio de Marcos .	mitãrusu;*:n ohechakuaákuri;<hecha+kuri:v|<hecha:v upe;*|*:n aranduka ha'eha;'e:v Biblia ha ojepe'aha;pe'a:v Marcos rembihaípe .
el muchacho;*:n interrumpió;interrumpir:v la lectura;*:n del viejo;*:a|*:n y le preguntó;preguntar:v : -“ Señor , ¿ usted todavía cree;creer:v|crear:v en ese libro;*:n|librar:v lleno;llenar:v|*:a|*:n de fábulas;fábula:n y cuentos;cuento:n ?”.	mitãrusu;*:n ojoko;ko:v|joko:v pe;*|*:n tujami moñe'ẽ ha oporandu;porandu:v : -“ Karai , ¿ ndépiko;nde:n|nde+piko:n reguerovia;rovia:v gueterei pe;*|*:n aranduka henyhẽva;<henyhẽ:v morangu;*:n ha ñemombe'úgui;mombe'u:n ?”.
-“ Sí , mas no es;ser:v un;*:a libro;*:n|librar:v de cuentos;cuento:n , es;ser:v la Palabra de Dios , o ¿ estoy;estar:v equivocado;equivocar:v|*:a ?”.	-“ Aguerovia , hákatu kóvango;kóva:n ndaha'é ñemombe'urei aranduka , kóvango;kóva:n Tupã;tupã:n ñe'ẽ;*:n , térãpa ajavy;<javy:v|ja:v ”.
-“ Pero claro;*:a|*:n que lo está;estar:v .	-“ Héẽ , rejavy;<javy:v|ja:v .
creo;creer:v|crear:v que usted señor;*:n debería;deber:v estudiar;*:v Historia Universal y verá;ver:v que la Revolución Francesa , ocurrida;ocurrir:v hace;hacer:v más de 100 años;año:n , mostró;mostrar:v la miopía;*:n de la religión;*:n .	chénteko;che+ko:n|che:n ha'e;*|'e:v|*:n nde;*|*:n remoñe'ẽva'erãha Arapy Rembiasakue ha upépe;upe:n rehechakuaáta;<hecha:v Revolución Francesa , ojehuva'ekue;jehu:v 100 ary;*:n rasamíma , ohechaukahague;<hecha:v|<hechauka:v jeroviakatu vyroreiha .
solamente personas;persona:n sin cultura;*:n todavía creen;creer:v|crear:v que Dios hizo;hacer:v el mundo;*:n en 6 días;día:n .	tapicha;<hapicha:n tavýnte;tavy+nte:s|tavy:n oguerovia;rovia:v gueterei Tupã;tupã:n ojapohague;<japo:v yvóra 6 árape;ára:n .
usted señor;*:n debería;deber:v conocer;*:v un;*:a poco;*:a|*:n más lo que los Científicos dicen;decir:v de todo;*:a eso ”.	ndéngo;nde:n reñeha'ãva'erã;ha'ã:v|ñeha'ã:v reikuaamive;kuaa:v mba'épa;*|mba'e:n he'i;'e:v umi tembikuaatyhára umi mba'ére;mba'e:n ”.
-“ Y ... ¿ es;ser:v eso mismo;*:a lo que los científicos;científico:n dicen;decir:v sobre;*|sobrar:v|*:n la Biblia ?”, preguntó;preguntar:v el viejo;*:a|*:n .	-“ Ha … ¿ umíva umi mba'épiko;mba'e+piko:s|mba'e:n he'i;'e:v umi tembikuaatyhára Biblia - pe;*|*:n ojehaívare;hai:v ?”, oporandu;porandu:v tujami .
-“ Como voy;ir:v a bajar;*:v en la próxima;próximo:a estación;*:n , no tengo;tener:v tiempo;*:n de explicarle;explicar:v (le) .	-“ Aguejýtagui ambue;*:n japytatahápe , nda'ijavéima chéve;che:n amyesakã haĝua ndéve;nde:n .
déme su tarjeta;*:n para mandarle;mandar:v (le) material;*:n sobre;*|sobrar:v|*:n este;*:n tema;temer:v|*:n ”, respondió;responder:v el joven;*:a|*:n al anciano;*:a|*:n .	eme'ẽna;me'ẽ:v chéve;che:n ne;nde:n kuatia'atã'i ikatuhaĝuáicha amoĝuahẽ;guahẽ:v ndéve;nde:n heta;<heta:v marandu;*:n ko mba'e;*:n rehegua ”, ombohovái;mbohovái:v tujamí upe;*|*:n mitãrusúpe;mitãrusu:n .
el anciano;*:a|*:n entonces , con mucha;mucho:a paciencia;*:n , sacó;sacar:v su tarjeta;*:n y se la dio;dar:v al muchacho;*:n .	upérõ;upe:n|upe+rõ:s tujami , mbeguekatumi , onohẽ ikuatia'atã'i ha ome'ẽ;me'ẽ:v mitãrusúpe;mitãrusu:n .
cuando éste leyó;leer:v lo que allí decía;decir:v se sobresaltó;sobresaltar:v y salió;salir:v cabizbajo;*:a .	kóva;*|*:n omoñe'ẽvo;moñe'ẽ+vo:v|ñe'ẽ+vo:v hese;ha'e:n he'íva;'e:v oñemondýi;mondýi:v ha ñakãitýpe oho;ha:v .
en la tarjeta;*:n decía;decir:v : Profesor Doctor Louis Pasteur , Director General del Instituto de Investigaciones Científicas , Universidad Nacional de Francia .	kuatia'atã'íre he'i;'e:v : Mbo'ehára Tembikuaajára Louis Pasteur , Tembikuaareka Renda Motenondehára , Francia Retã Mbo'ehaovusu .
“ Un poco;*:a|*:n de ciencia;*:n nos aparta;apartar:v de Dios .	“ Michĩ jave;*|ja:n tembikuaaty ñanemomombyry Tupãgui;tupã:n .
mucha;mucho:a , nos aproxima;aproximar:v ”.	heta;<heta:v jave;*|ja:n , ñanemo'aĝui ”.
esta antigua;antiguo:a leyenda;*:n intenta;intentar:v explicar;*:v la causa;*:n del porqué;*:n los Tupi viven;vivir:v en el Brasil y los Guarani en el Paraguay .	ko mombe'upy;mombe'u:n tujaite oñeha'ẽ ombohovái;mbohovái:v mba'eicharupípa Tupi oĩ;ĩ:v Brasil - pe;*|*:n ha Guarani katu Paraguay;paraguay:n retãme;<hetã:n .
dos;*:a|*:n hermanos;hermano:n , Guarani y Tupi , llegaron;llegar:v con sus familiares;familiar:n|familiar:a a América .	mokõi;*:n joyke'y;*:n , Guarani ha Tupi oĝuahẽkuri;guahẽ:v|guahẽ+kuri:v ipehẽnguekuéra;pehẽngue:n ndive Amérikape .
después de buscar;*:v por mucho;*:a tiempo;*:n a hombres;hombre:n y mujeres;mujer:n como;*|comer:v ellos , se dieron;dar:v cuenta;contar:v|*:n con esta enorme;*:a extensión;*:n de tierra;*:n solamente habían;haber:v campos;campo:n , montes;monte:n|montar:v y animales;animar+les:v|animal:n salvajes;salvaje:n .	heta;<heta:v oheka;<heka:v rire kuimba'e;*:n ha kuña;*:n ha'ekueraichagua;ha'e:n , ohechakuaa;<hecha:v hikuái ko yvy;*:n guasuetépe oĩha;ĩ:v ñu;*:n , ka'aguy;ka'a:n|*:n ha mymba;*:n ñarõ mante .
luego de la larga;largo:a|*:n|largar:v búsqueda;*:n y al no encontrar;*:v semejantes , fundaron;fundar:v sus pueblos;pueblo:n .	heta;<heta:v oheka;<heka:v rire ha ndojuhúimarõ;juhu:v (rõ) hapichakuerarã ; upémarõ;upe:s (rõ) , omoheñói;<heñói:v itavarã .
en esas comunidades;comunidad:n vivieron;vivir:v por mucho;*:a tiempo;*:n en paz;*:n y amistad;*:n , juntos;junto:a y solidariamente .	umi táva;*:n rupi;*|<hupi:n oiko;ko:v|iko:v heta;<heta:v ára;*:n teko;<heko:n marangatu ha mborayhu;*:n pa'ũme;pa'ũ:n , oñondivepa , jekupytýpe .
viviendo;vivir:v así;*|asir:v comenzaron;comenzar:v a multiplicarse;multiplicar:v (se) y a tener;*:v sus desavenencias;desavenencia:n .	upéicha;upe:n oikokuévo oñepyrũ;pyrũ:v|ñepyrũ:v hetave;<heta:v ha avei oikovaiñepyrũkuri ojoapytépe .
ya no podían;poder:v vivir;*:n|*:v en armonía;*:n .	ndaikatuvéima;katu:v oiko;ko:v|iko:v hikuái peteĩ;*:n ñe'ẽme;ñe'ẽ:n .
un;*:a día;*:n pelearon;pelear:v muy violentamente .	peteĩ;*:n ára;*:n oñorairõmbaguasúkuri .
la causa;*:n de dicho;*:n|decir:v conflicto;*:n fue;ir:v|ser:v la pelea;pelear:v|*:n que sostuvieron;sostener:v las esposas;esposa:n de dos;*:a|*:n Caciques por la posesión;*:n de un;*:a loro;*:n que vivía;vivir:v en las proximidades;proximidad:n de sus chozas;choza:n .	upe;*|*:n mba'e;*:n ojehu;jehu:v mokõi;*:n kuña;*:n omendáva;menda:v mokõi;*:n mburuvicháre;mburuvicha:n , oipotágui;pota:v imba'erã peteĩ;*:n gua'a;*:n oikova hogakuéra;<hóga:n jerére;jere:n .
entonces los dos;*:a|*:n Caciques se dieron;dar:v cuenta;contar:v|*:n que en esa gran;grande:a disputa;disputar:v|*:n podían;poder:v eliminarse;eliminar:v (se) mutuamente y por eso resolvieron;resolver:v separarse;separar:v (se) desde ese día;*:n .	upémarõ;upe:s (rõ) umi mokõi;*:n mburuvicha;*:n ohechakuaa;<hecha:v upe;*|*:n ñorairõ;*:n guasúpe;guasu:n ojojukapataha hikuái ; upévare;upe:n oñemomombyry;ñemomombyry:v ñepyrũ;pyrũ:n upe;*|*:n ára;*:n guive .
el mayor;*:a|*:n , Tupi , quedó;quedar:v en el actual;*:a territorio;*:n del Brasil , donde ya estaba;estar:v viviendo;vivir:v ; y el menor;*:a|*:n llamado;llamar:v|*:a Guarani , vino;venir:v|*:n con los suyos al sur;*:n , al territorio;*:n del Paraguay y sus alrededores;alrededor:n .	tyke'ýra;ryke'y:n , ha'éva;'e:v|ha'e:n Tupi , opyta;pyta:v Brasilpe , oikohapevoi ; ha tyvýra;ryvy:n , hérava;<héra:n|<héra:v Guarani , oúkuri;ju:v|ju+kuri:v ipehẽnguekuéra;pehẽngue:n ndive , Ñemby gotyo , Paraguay;paraguay:n retã;<hetã:n ha ijerére;jere:n .
al pasar;*:v la fiesta;*:n de la Virgen de Ka'akupe todos;todo:a ya se aprestan;aprestar:v para celebrar;*:v la más grande;*:a fiesta;*:n de la tradición;*:n cristiana;cristianar:v : la Navidad o Natividad ; es;ser:v decir;*:v , la recordación del Nacimiento del Niño Jesús .	ohasávo;<hasa:v (vo) Tupãsy Ka'akupe ára;*:n opavave oñembosako'íma;mbosako'i:v|ñembosako'i:v oguero'ayvu haĝua pe;*|*:n vy'a;*:n tuichavéva , cristiano rekópe;<heko:n , ha'éva;'e:v|ha'e:n Arareñói térã Tupãra'y;tupã:n Arareñói gueromandu'a .
en efecto;*:n , en todo;*:a el mundo;*:n cristiano;*:n|cristianar:v , el 24 de diciembre;*:n es;ser:v Nochebuena y el 25 de diciembre;*:n es;ser:v Navidad .	añetehápe;*|añete:n , ko yvóra tuichakue;*:n javeve;veve:v , 24 jasypakõi;*:n ha'e;*|'e:v|*:n Pyharemarangatu ha 25 jasypakõi;*:n katu Arareñói .
tiempo;*:n de reflexión;*:n , de perdón;*:n , de amor;*:n .	mokõive;mokõi:n , peteĩme;peteĩ:n , ha'e;*|'e:v|*:n py'amongeta;*:n , ñyrõ ha mborayhu;*:n ára;*:n .
la Navidad representa;representar:v una;uno:n|un:a|unir:v nueva;*:n|nuevo:a oportunidad;*:n para renovar;*:v la vida;*:n , para corregir;*:v el camino;*:n|caminar:v , para celebrar;*:v la vida;*:n .	arareñói niko peteĩ;*:n pa'u opavave jaguerekóva;reko:v ñambopyahu;mbopyahu:v haĝua ñande;*|*:n rekove;<heko:n|<hekove:n ; ñamyatyrõ;myatyrõ:v haĝua ñande;*|*:n rape;<hape:n ha jaguero'ayvu haĝua teko;<heko:n .
es;ser:v el tiempo;*:n para deponer rencores;rencor:n y maldades;maldad:n .	upe;*|*:n árape;ára:n tekotevẽ;<hekotevẽ:n ñamboyke;mboyke:v ñeko'õi;ko'õi:n|*:n ha ñaña;*:n .
no existe;existir:v nada;*:n|nadar:v más bonito;*:a|*:n esa noche;*:n que confundirse;confundir:v (se) en un;*:a fuerte;*:a|*:n y emotivo abrazo;abrazar:v|*:n con los seres;ser:n queridos;querido:n|querido:a|querer:v y dejar;*:v al Niño Jesús que renazca en nuestros corazones;corazón:n y en nuestras vidas;vida:n .	ndaipóri mba'e;*:n iporãvéva;porã:v upe;*|*:n pyharépe;py:n|pyhare:n jahechárõ;<hecha:v (rõ) opavavépe oñoañuãvo mbarete;*:n porã;po:n ha upe;*|*:n jave;*|ja:n jahejávo;<heja:v (vo) Tupãra'ýpe;tupã:n heñoijey ñandepype;ñande:n .
es;ser:v costumbre;*:n preparar;*:v el pesebre;*:n para revivir la Navidad de Jesús .	oikembaretéma ñande;*|*:n jepokuaápe;jepokuaa:n mymbakeha apo;*:n|po:v , jagueromandu'a haĝua Tupãra'y;tupã:n Arareñói .
la preparación;*:n se hace;hacer:v a partir;*:v del 15 de diciembre;*:n , otros;otro:n|otro:a lo hacen;hacer:v el día;*:n 20 y algunos;alguno:a el día;*:n de la Nochebuena .	oĩ;ĩ:v ojapóva;<japo:v 15 jasypakõime ; ambue;*:n katu ojapo;<japo:v ára;*:n 20 ha oĩ;ĩ:v avei ojepóva upe;*|*:n Pyharemarangatu árape;ára:n .
se cuenta;contar:v|*:n que la tradición;*:n nació;nacer:v de la mano;manar:v|*:n de San Francisco de Asís en el siglo;*:n XIII después de Cristo , esparciéndose;esparcir:v (se) posteriormente a todo;*:a el mundo;*:n ; siendo;ser:v el objetivo;*:n esencial revivir con imágenes;imagen:n el nacimiento;*:n de Jesús - hace;hacer:v más de 2.000 años;año:n - en un;*:a humilde;*:a pesebre;*:n de Belén , rodeado;rodear:v de María y José ; también , de animales;animar+les:v|animal:n ( vacas;vaca:n , ovejas;oveja:n , burros;burro:n , gallo;*:n ) y de algunos;alguno:a pastores;pastor:n ; a quienes - unos;un:a días;día:n después - se sumaron;sumar:v en la adoración;*:n los Tres Reyes Magos , que fueron;ir:v|ser:v guiados hasta el lugar;*:n por una;uno:n|un:a|unir:v estrella;*:n|estrellar:v .	ko jepokuaa;*:n niko omoheñoi'ypýkuri Francisco de Asís Marangatu , sa'ary'aty XIII Kirito rireguápe ha upégui;upe:n herakuãva'ekue oparupiete ; ojegueromandu'a haĝua , ta'ãngamimi rupive;<hupi:n , Hesu arareñói - ojapo;<japo:v 2.000 ary;*:n - peteĩ;*:n mymbakeha mboriahumíme , amoite Belén - me;*:n , ha oĩháme ijerére;jere:n Maria ha Hose ; avei , mymbamimi ( vaka;*:n , ovecha;*:n , chavurro ha kupyju ) ha ovechañangarekohára ; ha umívape , upe;*|*:n rire , omoirũkuri;moirũ:v|moirũ+kuri:v Tupãra'y;tupã:n jehechakuaápe umi Mbohapy Karai Mba'ekuaa , oĝuahẽva'ekue;guahẽ:v upépe;upe:n peteĩ;*:n mbyja;*:n ñesãmbyhy;sãmbyhy:n rupive;<hupi:n .
ya en su inicio;iniciar:v|*:n , diciembre;*:n se llena;lleno:a|llenar:v de los frutos;fruto:n de la tierra;*:n : sandías , melones , piñas;piña:n , uvas;uva:n ; además , del rico;*:a|*:n choclo;*:n ; y todo;*:a el Paraguay se cubre;cubrir:v del agradable;*:a y característico olor;*:n de la flor;*:n de coco;*:n .	oñepyrũvo;ñepyrũ+vo:v|pyrũ+vo:v , jasypakõi;*:n henyhẽmavoi opaichagua;opa:n temitýgui : sandia , merõ;*:n , avakachi;*:n , úva;*:n ; upéicha;upe:n avei , hetéva;<hete:n avatiky;*:n ; ha Paraguáy tuichakue;*:n javeve;veve:v henyhẽ;<henyhẽ:v mbokaja;*:n poty;*:n ryakuã asyetévagui .
hasta hoy la gente;*:n del campo;*:n sale;salir:v|salar:v a buscar;*:v las ramas;rama:n de ka'avove'i , arbusto;*:n que abunda;abundar:v en esta época;*:n .	ko'aĝaite peve;*|pe:n ñande;*|*:n rapicha;<hapicha:n okaraygua;*:n osẽ;sẽ:v oheka;<heka:v ha oikytĩ;kytĩ:v ka'avove'i rakãmimi , okakuaáva;kakuaa:v oparupiete .
esas ramas;rama:n son;*:n|ser:v clavadas;clavar:v en el suelo;*:n|soler:v , formando;formar:v el pesebre;*:n , a modo;*:n de pequeño;*:a altar;*:n ; y dentro del mismo;*:a los miembros;miembro:n de la familia;*:n|familiar:v alojan;alojar:v las imágenes;imagen:n de arcilla;*:n de Jesus , Santa María , San José , el Ángel Gabriel , la paloma;*:n , la estrella;*:n|estrellar:v , los pastores;pastor:n , los animales;animar+les:v|animal:n : vacas;vaca:n , ovejas;oveja:n , burros;burro:n , el gallo;*:n y por supuesto;suponer:v|*:n los infaltables y siempre esperados;esperar:v Tres Reyes Magos .	ka'avove'i rakãmimi ojegueru;ru:v ha ojekutujereva'erã , ojejapóvo;<japo:v (vo) heseve peteĩ;*:n tapỹi'i;tapỹi:n , ojoguáva;jogua:v upe;*|*:n mymbakeha , Hesu heñoihaguépe ; ha ipype;ha'e:n oñemohenda;mohenda:v|ñemohenda:v vy'apópe umi ta'ãngamimi ojejapóva;<japo:v ñay'ũgui : Hesu , Maria Marangatu , Hose Marangatu , Gabriel Tupãremimbou , pykasu;*:n , mbyja;*:n , ovachañangarekohára ha umi mymbamimi : vaka;*:n , ovecha;*:n , chavurro , kupyju ; ha upéicha;upe:n avei , umi ojehecharamovéva;<hecha:v ha oñeha'ãrõvéva;ha'ã:v|ñeha'ã:v ha'éva;'e:v|ha'e:n umi Mbohapy Karai Mba'ekuaa .
como;*|comer:v ofrenda;*:n|ofrendar:v se ubicarán;ubicar:v alrededor del pesebre;*:n la flor;*:n de coco;*:n , sandías , melones , piñas;piña:n , naranjos , bananos;banano:n , etc .	temikuave'ẽrõ oñemoĩ;ñemoĩ:v|ĩ:v|moĩ:v avei pe;*|*:n mymbakeha jerére;jere:n : mbokaja;*:n poty;*:n , sandia , merõ;*:n , avakachi;*:n , narã;*:n , pakova;*:n ha ambuéva;ambue:n .
al atardecer;*:n|*:v una;uno:n|un:a|unir:v vela;velar:v|*:n se encenderá;encender:v para recordar;*:v a Jesus que es;ser:v luz;*:n y es;ser:v vida;*:n .	ka'arupytũ jave;*|ja:n katu oñemyendyva'erã;myendy:v peteĩ;*:n tataindy;<hataindy:n ojegueromandu'ávo Hesúpe , ha'éva;'e:v|ha'e:n tesape;<hesape:n ha tekove;<heko:n|<hekove:n .
el día;*:n de la Nochebuena , las familias;familia:n se reúnen;reunir:v en la casa;*:n|casar:v de los padres;padre:n .	pyharemarangatu árape;ára:n , pehẽnguekuéra;pehẽngue:n ijatypaite ituvakuéra;ru:n rógape;<hóga:n .
los que son;*:n|ser:v del interior;*:n y que viven;vivir:v lejos de sus padres;padre:n ( dentro del país;*:n o fuera;ir:v|*:n|ser:v de él ) retornan;retornar:v a sus hogares;hogar:n para pasar;*:v todos;todo:a juntos;junto:a la Nochebuena y la Navidad .	umi okarayguáva;okaraygua:n ha oikóva;ko:v|iko:v ambue;*:n ñane;ñande:n retã;<hetã:n táva;*:n rupi;*|<hupi:n térã oikóva;ko:v|iko:v ambue;*:n tetãme;<hetã:n , ojevypaite hógape;<hóga:n ikatuhaĝuáicha ohasa;<hasa:v oñondivepa Pyharemarangatu ha Arareñói .
en el horno;*:n se preparan;preparar:v ricos;rico:n|rico:a platos;plato:n como;*|comer:v el asado;*:a|*:n|asar:v de cerdo;*:n , gallina;*:n , carne;*:n vacuna;vacuno:a|vacunar:v|*:n u oveja;*:n .	tatakuápe;<hatakua:n oñembojy;jy:v umi tembi'u;<hembi'u:n hevéva ha ñanemba'etéva , umíva apytépe;*|apyte:n : kure;*:n , ryguasu;*:n , vaka;*:n ro'o;so'o:n ha ovecha;*:n .
también de ese horno;*:n salen;salir:v|salar:v humeantes y olorosas;oloroso:a sopas;sopa:n paraguayas y chipa guasu .	upe;*|*:n tatakuágui;<hatakua:n osẽ;sẽ:v avei hyakuã;<hyakuã:v asýva sópa paraguái;*:n ha chipa;*:n guasu;*:n .
en tanto;*:n , en una;uno:n|un:a|unir:v enorme;*:a olla;*:n se hierve;hervir:v la mandioca;*:n .	peteĩ;*:n japepo;*:n guasúpe;guasu:n katu oñembopupu;pupu:v mandi'o;*:n .
asimismo , se prepara;preparar:v el rico;*:a|*:n clericó , mezclando;mezclar:v toda;todo:a clase;*:n de frutas;fruta:n : manzanos;manzano:n , naranjos , piñas;piña:n y uvas;uva:n .	upéicha;upe:n avei , ojejapo;<japo:v pe;*|*:n mba'erykue hérava;<héra:n|<héra:v keleriko , oñembojehe'ávo opaichagua;opa:n yva;*:n : manasána , narã;*:n , avakachi;*:n ha úva;*:n .
un;*:a cántaro;*:n lleno;llenar:v|*:a|*:n de clericó se ubica;ubicar:v al costado;costar:v|*:n del pesebre;*:n para servir;*:v a los visitantes;visitante:n en jarros de arcilla;*:n .	peteĩ;*:n kambuchi;*:n renyhẽte kelerikógui oñemoĩ;ñemoĩ:v|ĩ:v|moĩ:v pe;*|*:n mymbakeha ykére;*|yke:n ojeitykua haĝua - peteĩ;*:n kaguápe - opavave oñembojávape;mboja:v|ja:v|ñemboja:v ohecha;<hecha:v haĝua pe;*|*:n mymbakeha .
al atardecer;*:n|*:v , los niños;niño:n y más jóvenes;joven:n|joven:a ya están;estar:v todos;todo:a recién bañados;bañar:v , limpios;limpio:a , bien;*|*:a|*:n peinados;peinado:a|peinar:v , luciendo;lucir:v ropas;ropa:n nuevas;nueva:n|nuevo:a .	ka'arupytũvo , mitã;*:n ha mitãrusumimi ojahu;jahu:v ha ipotĩ'asýma;potĩ:v , oñemoapesýi ha omoĩ;ĩ:v|moĩ:v ijao;ao:n pyahu .
ellos salen;salir:v|salar:v a recorrer;*:v el vecindario;*:n , a visitar;*:v los pesebres .	ha'ekuéra;*|ha'e:n oho;ha:v opavave hogaykereguápe , ohechávo;<hecha:v (vo) pe;*|*:n mymbakeha .
siendo;ser:v recibidos;recibir:v por los dueños;dueño:n de casas;casa:n , que los hacen;hacer:v pasar;*:v hasta donde está;estar:v el pesebre;*:n y allí sentados;sentar:v miran;mirar:v el pesebre;*:n .	upépe;upe:n ogajarakuéra omomaitei;momaitei:v , ombohasa;mbohasa:v|<hasa:v ha omboguapy;guapy:v chupekuéra;ha'e:n pe;*|*:n mymbakeha renondépe;*|<henonde:n .
los dueños;dueño:n de casas;casa:n les servirán;servir:v un;*:a pedazo;*:n de sopa;*:n , el clericó y a la ida;*:n los visitantes;visitante:n reciben;recibir:v caramelos;caramelo:n .	ogajarakuéra ogueropojái;pojái:v chupekuéra;ha'e:n sópa ha keleriko ; ha ohokuetévo hikuái ome'ẽ;me'ẽ:v chupekuéra;ha'e:n mba'ehe'ẽmimi .
es;ser:v costumbre;*:n repetir;*:v una;uno:n|un:a|unir:v frase;*:n ritualística por todos;todo:a conocida;conocer:v|conocido:a “ Que lindo;*:a|lindar:v es;ser:v tu pesebre;*:n ”.	upe;*|*:n jave;*|ja:n katuete umi ouva'ekue;ju:v ohecha;<hecha:v mymbakeha , he'íva'erã “ Iporãitépa nde;*|*:n pesebre ”.
ya entrada;*:n|entrar:v la noche;*:n y hasta la medianoche;*:n ; es;ser:v decir;*:v , hasta la Navidad se escucha;*:n|escuchar:v la explosión;*:n de bombas;bomba:n , bombitas y mbokavicho ; además , los niños;niño:n encienden;encender:v sus estrellitas .	pyharévoma;py:n|pyhare:n ha pyharepyte peve;*|pe:n ; ja'eporãsérõ Arareñói meve;*|me:n oñehendu;<hendu:v ñembokapu;mbokapu:n : mba'ekapuha guasu;*:n , mba'ekapuha'i ha mbokavícho ; upéicha;upe:n avei , mitãmimi omyendy;myendy:v mbyja'ikuéra;mbyja:n .
luego , cerca;*:n|cercar:v de la medianoche;*:n o a la medianoche;*:n , los miembros;miembro:n de la familia;*:n|familiar:v se sientan;sentar:v|sentir:v alrededor de la mesa;*:n , cubierta;cubrir:v|cubierto:a|*:n por un;*:a mantel;*:n blanco;*:a|*:n de ao po'i , a compartir;*:v la cena;cenar:v|*:n de Nochebuena y Navidad , escuchando;escuchar:v villancicos y canciones;canción:n de navidad .	upe;*|*:n rire , pyharepytepotávo térã pyharepytete jave;*|ja:n , oñepehẽnguéva oguapypaite;guapy:v mesa jerere;jere:n , oñembo'apéva ao;*:n po'ípe;po:n , okarupyharévo ; omoĝuahẽvo;guahẽ:v (vo) ijapýpe;ja:n|apy:n Pyharemarangatu ha omomaiteívo;momaitei:v (vo) Arareñói , ohenduhápe;<hendu:v opaichagua;opa:n arareñói mba'epu'i ha purahéi .
a la medianoche;*:n , entre;*|entrar:v explosiones;explosionar:v|explosión:n de petardos;petardo:n , todos;todo:a se confunden;confundir:v en un;*:a fuerte;*:a|*:n abrazo;abrazar:v|*:n , y entre;*|entrar:v besos;beso:n y lágrimas;lágrima:n , se saludan;saludar:v con un;*:a FELIZ NAVIDAD .	pyharepyte oĝuahẽvo;guahẽ:v (vo) , mbokapupara pa'ũme;pa'ũ:n , ñeañuã hatãva;<hatã:n|<hatã:v rupi;*|<hupi:n , ñehetũ;*:n ha tesaýpe;<hesay:n , opavave oñomomaitei;momaitei:v , he'ívo;'e:v (vo) ojupe VY'APAVẼ TUPÃRA'Y ARAREÑÓIRE .
finalmente , frente;*:n al pesebre;*:n , todos;todo:a elevan;elevar:v una;uno:n|un:a|unir:v oración;*:n celebrando;celebrar:v el Nacimiento del Niño Jesús .	ipahápe;*|pa:n|paha:n , opavave oñemboja;mboja:v|ja:v|ñemboja:v mymbakeha renondépe;*|<henonde:n ha oñembo'e;mbo'e:v|ñembo'e:v omomorãvo;momorã:v (vo) Tupãra'y;tupã:n Arareñói .
un;*:a hombre;*:n murió;morir:v y se dio;dar:v cuenta;contar:v|*:n que Dios venía;venir:v a buscarlo;buscar:v (lo) con una;uno:n|un:a|unir:v maleta;*:n en la mano;manar:v|*:n .	peteĩ;*:n kuimba'e;*:n omano;mano:v ha oñandu;<ñandu:v Ñande Ru ouha;ju:v ipiári peteĩ;*:n mba'eryru;*:n ipópe;po:n .
dios;*:n le dijo;decir:v : “ Bien hijo;*:n es;ser:v hora;*:n de irnos;ir:v (nos) ”.	ñande;*|*:n Ru he'i;'e:v chupe;ha'e:n : “ Néi che;*|*:n ra'y jahamava'erã;ha:v ”.
el hombre;*:n asombrado;asombrar:v preguntó;preguntar:v : “ Ya ? Tan pronto;*:a|*:n ?	kuimba'emi;kuimba'e:n oporandu;porandu:v py'atytýipe : “ Áĝamapiko . Pya'etépa .
tenía;tener:v muchos;mucho:a planes;plan:n ...”	hetaite;<heta:v mba'e;*:n niko ajaposevékuri;<japo+kuri:v|<japo:v …”
-“ Lo siento;sentar:v|sentir:v pero;*|*:n es;ser:v el momento;*:n de tu partida;partir:v|*:n .”	-“ Che avéniko;a:n ambyasy jepémo upéicha;upe:n rehómava'erã;ha:v .”
-“ Que traes en la maleta;*:n ?”, preguntó;preguntar:v el hombre;*:n .	-“ Mba'éiko regueru;ru:v pe;*|*:n mba'eryrúpe;mba'eryru:n ”, oporandu;porandu:v kuimba'e;*:n .
y Dios le respondió;responder:v : “ Tus pertenencias;pertenencia:n ...”	ha Ñande Ru ombohovái;mbohovái:v : “ Ne rembipurukuéra …”
-“ Mis pertenencias;pertenencia:n ?, Traes mis cosas;coser:v|cosa:n , mi ropa;*:n , mi dinero;*:n ?”	-“ Che rembipurukuéra piko . Reguerúpiko che;*|*:n mba'éva;mba'e:n guive , che;*|*:n ao;*:n , che;*|*:n viru;*:n ”
dios;*:n le respondió;responder:v : “ Eso nunca te perteneció;pertenecer:v , eran;ser:v de la tierra;*:n .”	ñande;*|*:n Ru ombohovái;mbohovái:v : “ Umíva niko nanemba'éi , yvy;*:n mba'e;*:n niko umíva .”
-“ Traes mis recuerdos;recuerdo:n ?”	-“ Reguerúpa che;*|*:n remimandu'akuéra .”
-“ Esos nunca te pertenecieron;pertenecer:v , eran;ser:v del tiempo;*:n .”	-“ Umíva niko nanemba'éi , umíva niko ára;*:n mba'e;*:n .”
-“ Traes mis talentos;talento:n ?”	-“ Reguerúpa che;*|*:n rekomba'erepy .”
-“ Esos no te pertenecieron;pertenecer:v , eran;ser:v de las circunstancias;circunstancia:n .”	-“ Umíva niko nanemba'éi , umíva niko tembiasa;<hembiasa:n mba'e;*:n .”
-“ Traes a mis amigos;amigo:n , a mis familiares;familiar:n|familiar:a ?”	-“ Reguerúpa che;*|*:n angirũ;*:n ha che;*|*:n pehẽnguekuérape;pehẽngue:n .”
-“ Lo siento;sentar:v|sentir:v , ellos nunca te pertenecieron;pertenecer:v , eran;ser:v del camino;*:n|caminar:v .”	-“ Mba'erãpa rombotavýta;mbotavy:v|mbota:v , ha'ekuéra;*|ha'e:n niko nanemba'éi , ha'ekuéra;*|ha'e:n niko tape;<hape:n mba'e;*:n .”
-“ Traes a mi mujer;*:n y a mis hijos;hijo:n ?”	-“ Reguerúpa che;*|*:n rembireko;<hembireko:n ha che;*|*:n ñemoñarekuérape;ñemoña:n|moña:n|ñemoñare:n .”
-“ Ellos nunca te pertenecieron;pertenecer:v , eran;ser:v de tu corazón;*:n .”	-“ Ha'ekuéra niko nanemba'éi , ha'ekuéra;*|ha'e:n niko ne;nde:n korasõ;*:n mba'e;*:n .”
-“ Traes mi cuerpo;*:n ?”	-“ Reguerúpa che;*|*:n rete;<hete:n .”
-“ Nunca te perteneció;pertenecer:v , ese era;*:n|ser:v del polvo;*:n .”	-“ Araka'eve niko nanemba'éi , upéva;*|upe:n niko yvytimbo;*:n rehegua .”
-“ Entonces traes mi alma;*:n ?”	-“ Upéicharõpiko regueru;ru:v che;*|*:n ã;*:n .”
-“ No , esa es;ser:v mía .”	-“ Nahániri , upéva;*|upe:n chemba'e .”
entonces el hombre;*:n lleno;llenar:v|*:a|*:n de miedo;*:n , le arrebató;arrebatar:v a Dios la maleta;*:n y al abrirla;abrir:v (la) se dio;dar:v cuenta;contar:v|*:n que estaba;estar:v vacía;vacío:a|vaciar:v .....	upémarõ;upe:s (rõ) kuimba'emi;kuimba'e:n henyhẽva;<henyhẽ:v kyhyjégui;kyhyje:n , ohekýi;<hekýi:v Ñande Rúgui pe;*|*:n mba'eryru;*:n ha omañávo;maña:v (vo) hyepýpe;<hye:n ojuhu;juhu:v nandiha;nandi:n …
con lágrimas;lágrima:n en los ojos;ojo:n , el hombre;*:n dijo;decir:v : “ Nunca tuve;tener:v nada;*:n|nadar:v ?”	tesay;<hesay:n kukúipe kuimba'e;*:n osẽ;sẽ:v he'i;'e:v : “ Araka'evepiko ndarekoivoíkuri mba'eve;mba'e:n .”
-“ Así es;ser:v , cada uno;*:n|unir:v de los momentos;momento:n que viviste;vivir:v fueron;ir:v|ser:v solo;*|*:a|*:n tuyos .	-“ Upeichaite , peteĩteĩ ha opaite;*|opa:n|pa:v mba'e;*:n rehasava'ekue;<hasa:v nde;*|*:n rekovépe;<heko:n|<hekove:n , nemba'ékuri .
la vida;*:n es;ser:v solo;*|*:a|*:n un;*:a momento;*:n ... Por eso , mientras estés;estar:v a tiempo;*:n disfrútala en su totalidad;*:n .	tekove;<heko:n|<hekove:n niko peteĩ;*:n tesapirĩnte;<hesapirĩ+nte:s|<hesapirĩ:n … Upévare , ikatu;katu:v aja;*|ja:v , eñeha'ãva'erã nde;*|*:n rekokatu ikatuha;katu:n|katu:v peve;*|pe:n .
que nada;*:n|nadar:v de lo que crees;crear:v que te pertenece;pertenecer:v te detenga;detener:v ...	ani mba'eve;mba'e:n - nde;*|*:n eréva;'e:v nemba'eha - ndejoko;ko:v|joko:v .
vive;vivir:v el ahora .	ko'aĝa reikova'erã;ko:v|iko:v .
vive;vivir:v tu vida;*:n ...	eikóke;ko:v|iko:v ha emoingovéke;moingo:v nde;*|*:n rekove;<heko:n|<hekove:n .
y no te olvides;olvidar:v de SER FELIZ , es;ser:v lo único;*:a que realmente vale;valer:v|*:n la pena;*:n|penar:v .	ha ani nderesarái;<hesarái:v nevy'apavẽva'erãha , upéva;*|upe:n añoite pe;*|*:n añeteguáva;añetegua:n .
las cosas;coser:v|cosa:n materiales;material:n y todo;*:a lo demás por lo que luchaste;luchar:v , se quedan;quedar:v aquí .	umi ne;nde:n rembipuru ha opaite;*|opa:n|pa:v ambue;*:n mba'e;*:n reñeha'ãva'ekuére;ha'ã:v|ñeha'ã:v opytáta;pyta:v ko'ápe .
no te llevarás;llevar:v nada;*:n|nadar:v de acá .	mba'evete ndereguerahamo'ãi;raha:v ko'águi .
valora;valorar:v a quienes te valoran;valorar:v y no pierdas;perder:v el tiempo;*:n con alguien que no tiene;tener:v tiempo;*:n para ti .	emomba'eguasu;momba'e:v|momba'eguasu:v umi nemomba'eguasúvape;momba'e:v|momba'eguasu:v ha ani rejesareko;jesareko:v umi nanderechakuaáivape;<hecha:v .
los Guarani suelen;soler:v decir;*:v que nuestro final;*:a|*:n no está;estar:v en la tierra;*:n , no somos;ser:v para acá ; por eso , la tierra;*:n no tiene;tener:v dueño;*:n , los animales;animar+les:v|animal:n no tienen;tener:v dueño;*:n , las plantas;planta:n no tienen;tener:v dueño;*:n .	guaranikuéra niko he'íva;'e:v ñande;*|*:n ndaha'éi ápe;*|a:n ĝuarã , upévare;upe:n yvy;*:n ndaijárai , mymba;*:n ndaijárai , ka'avo;*:n ndaijárai .
nosotros somos;ser:v simples;simple:a|simple:n transeúntes;transeúnte:n .	ñande;*|*:n jahasánte;<hasa+nte:v|<hasa:v ko'a rupi;*|<hupi:n .
no debemos;deber:v juntar;*:v nada;*:n|nadar:v pues nada;*:n|nadar:v llevaremos;llevar:v .	nañambyatýiva'erã mba'eve;mba'e:n , ndajaguerahamo'ãigui mba'eve;mba'e:n ko'águi .
venimos;venir:v a la tierra;*:n para lograr;*:v nuestra plenitud;*:n .	jaju;ju:v ñanderekokatu haĝua .
así;*|asir:v como;*|comer:v vinimos;venir:v , nos iremos;ir:v .	jajuhaguéicha;ju:v jahajeýta;ha:v .
aquí quedará;quedar:v nuestro cuerpo;*:n que se mezclará;mezclar:v con la tierra;*:n y nuestra alma;*:n se desprendará y migrará;migrar:v a la Tierra Sin Mal .	opytáta;pyta:v ñande;*|*:n rete;<hete:n ha ojehe'ajeýta yvýra ha ñane;ñande:n ã;*:n ojehekýita;jehekýi:v|<hekýi:v oho;ha:v haĝua Yvy Mara'ỹme .
aprovecha;aprovechar:v cada segundo;*:a|*:n que vivas;vivir:v|vivo:a pues solamente eso es;ser:v lo que llevarás;llevar:v contigo al abandonar;*:v la tierra;*:n .	eipurukuaáke opaite;*|opa:n|pa:v aravo'ive;aravo:n nde;*|*:n rekopegua;<heko:n , upevamínte ha'éva;'e:v|ha'e:n upe;*|*:n reguerahátava rohokuévo ko yvy;*:n ape;*:n árigui .
iniciamos;iniciar:v un;*:a nuevo;*:a|*:n año;*:n y en el ánimo;*:n de todos;todo:a está;estar:v el deseo;*:n|desear:v que el mismo;*:a sea;ser:v el mejor;*:a de todos;todo:a .	ñamoñepyrũ peteĩ;*:n ary;*:n pyahu ha opavavévante jaipota;pota:v oiko;ko:v|iko:v kóvagui;kóva:n pe;*|*:n ary;*:n iporãveva opavavetéva apytépe;*|apyte:n .
el año;*:n nuevo;*:a|*:n es;ser:v un;*:a desafío;*:n y a la vez;*:n una;uno:n|un:a|unir:v grande;*:a y nueva;*:n|nuevo:a oportunidad;*:n para intentar;*:v vivir;*:n|*:v mejor;*:a y cumplir;*:v todos;todo:a nuestros sueños;sueño:n .	ary;*:n pyahu niko ñanepy'ara'ã ha upekuévo;upe+vo:s|upe:n ha'e;*|'e:v|*:n avei peteĩ;*:n pa'ũ;*:n kakuaa ha ipyahúva;pyahu:v jaipykúi haĝua tekoporãve;<hekoporã:n rape;<hape:n ha ñamoañete haĝua maymave ñande;*|*:n kerayvoty;*:n .
podríamos;podrir:v|poder:v empezar;*:v este;*:n nuevo;*:a|*:n viaje;viajar:v|*:n con la siguiente reflexión;*:n de Pablo Neruda .	ñañepyrũkuaa;pyrũ:v|ñepyrũ:v ko guata;*:n pyahu karai;*:n guasu;*:n Pablo Neruda remiandu;<hemiandu:n rupive;<hupi:n .
no culpes;culpar:v a nadie .	ani rekaguai ndejehe .
nunca te quejes;quejar:v de nadie porque fundamentalmente tú has;haber:v hecho;hacer:v|*:a|*:n tu vida;*:n .	ani rejahéi;jahéi:v avavére;va:v|ava:n ndentevoi ha'égui;'e:v upe;*|*:n reje'apóva .
acepta;aceptar:v la responsabilidad;*:n de edificarte;edificar:v (te) a ti mismo;*:a .	reje'apo haĝua tekotevẽ;<hekotevẽ:n ndevoi;nde:n reñemoneĩ ndejupe .
el valor;*:n de acusarte;acusar:v (te) en el fracaso;fracasar:v|*:n para volver;*:v a empezar;*:v , corrigiéndote;corregir:v (te) .	rehechakuaávo;<hecha:v (vo) rejavyhague;<javy:v|ja:v reñepyrũjey'arã;pyrũ:v|ñepyrũ:v reguata;guata:v remyatyrõ;myatyrõ:v rire ne;nde:n rembiapo;<hembiapo:n vai .
el triunfo;*:n|triunfar:v del verdadero;*:a|*:n hombre;*:n surge;surgir:v de las cenizas;ceniza:n del error;*:n .	ava;va:v|*:n reko;<heko:n porã;po:n niko heñóiva mba'evai tanimbukuégui;tanimbu:n .
nunca te quejes;quejar:v del ambiente;*:n o de los que te rodean;rodear:v , hay quienes en tu mismo;*:a lugar;*:n supieron;saber:v vencer;*:v .	ani rekaguai nde;*|*:n rekoha;<heko:n|reko:n|<hekoha:n térã nde;*|*:n jerére;jere:n oikóvare;ko:v|iko:v , heta;<heta:v oĩ;ĩ:v upérupi ne;nde:n rendaguetépe oñakarapu'ãva'ekue .
las circunstancias;circunstancia:n son;*:n|ser:v buenas;bueno:a o malas;mala:n|malo:a según la voluntad;*:n o fortaleza;*:n de tu corazón;*:n .	tekokatu térã tekomarã heñói ndénte;nde:n|nde+nte:n reipotágui;pota:v ha ne;nde:n korasõ;*:n omoneígui .
aprende;aprender:v a convertir;*:v toda;todo:a situación;*:n difícil;*:a en un;*:a arma;armar:v|*:n para luchar;*:v .	opa;*:n|pa:v mba'e;*:n vai rehasávagui;<hasa:v rejapova'erã;<japo:v peteĩ;*:n tembipuru nepytyvõkuaáva;pytyvõ:v ñorairõháme .
no te quejes;quejar:v de la pobreza;*:n , de tu soledad;*:n o de tu suerte;*:n , enfréntalos con valor;*:n y acepta;aceptar:v que de una;uno:n|un:a|unir:v o otra;otro:n|otro:a forma;formar:v|*:n son;*:n|ser:v el resultado;resultar:v|*:n de tus actos;acto:n y la prueba;probar:v|*:n que has;haber:v de ganar;*:v .	ani reñembyasy;ñembyasy:v ne;nde:n mboriahu , ne'año térã nandepo'áihaguére , embohovakéke umívape ha upekuévo;upe+vo:s|upe:n rehechakuaáta;<hecha:v umi mba'e;*:n ouha;ju:v ne;nde:n rembiapokuégui;<hembiapo:n ha umíva rehe reñemotenondeva'erãha .
no te amargues;amargar:v con tus propios;propio:a|propio:n fracasos;fracaso:n , ni se los cargues;cargar:v a otros;otro:n|otro:a , acéptate ahora o seguirás;seguir:v justificándote como;*|comer:v un;*:a niño;*:n .	ani ndepy'arõ nendivevoi , ha ani rembohasa;mbohasa:v|<hasa:v ambue;*:n akã;*:n ári mba'e;*:n ndéve;nde:n ojehúva;jehu:v , ejehechakuaa;<hecha:v ko'áĝa ỹramo reñembotavýta;mbotavy:v|mbota:v|ñembotavy:v ku mitã;*:n oñembotavyháicha;mbotavy:v|mbota:v|ñembotavy:v ijupe;upe:n .
recuerda;recordar:v que cualquier momento;*:n es;ser:v bueno;*:a|*:n para comenzar;*:v y que ninguno;*:a es;ser:v tan terrible;*:a para claudicar .	opaite;*|opa:n|pa:v ára;*:n niko iporã;porã:v reñepyrũjey;pyrũ:v|ñepyrũ:v haĝua ha ndaipori pa'ũ;*:n , peteĩmínte;peteĩ:n|peteĩ+nte:s jepe;*|pe:n , ere;'e:v haĝua nderehupytymo'ãiha ne;nde:n rembipota;<hembipota:n .
deja;dejar:v ya de engañarte;engañar:v (te) , eres la causa;*:n de ti mismo;*:a , de tu necesidad;*:n , de tu dolor;*:n , de tu fracaso;fracasar:v|*:n .	anive reñembotavy;mbotavy:v|mbota:v|ñembotavy:v ndejupe , nde;*|*:n ha'e;*|'e:v|*:n opa;*:n|pa:v mba'e;*:n ypy;y:n|*:n , ndepypentevoi heñói umi ne;nde:n rembipota;<hembipota:n , ne;nde:n mba'embyasy , nde;*|*:n py'amirĩ .
si , tú has;haber:v sido;ser:v el ignorante;*:a|*:n , el irresponsable , tú únicamente tú , nadie puede;poder:v haber;*:v sido;ser:v por ti .	añetehápe;*|añete:n , ndentevoi upe;*|*:n rejekuaaporã'ỹva;jekuaa:v|kuaa:v ndejupe , upe;*|*:n hekokatu'ỹva , ndentevoi , avave;va:v|ava:n ndaikatúi;katu:v ojapo;<japo:v umi mba'e;*:n nderérape;<héra:v .
no olvides;olvidar:v que la causa;*:n de tu presente;presentar:v|*:a|*:n|presentir:v es;ser:v tu pasado;pasar:v|*:a|*:n , como;*|comer:v la causa;*:n de tu futuro;*:n es;ser:v tu presente;presentar:v|*:a|*:n|presentir:v .	aníke nderesarái;<hesarái:v , opaite;*|opa:n|pa:v mba'e;*:n ojehúva;jehu:v ndéve;nde:n ko'áĝa heñói nde;*|*:n reko;<heko:n ymavépe ; ha upéicha;upe:n avei , ne;nde:n renonderã;<henonde:n oñemopyenda nde;*|*:n reko;<heko:n ko'aĝaguápe .
aprende;aprender:v de los fuertes;fuerte:a|fuerte:n , de los audaces;audaz:a , imita;imitar:v a los valientes;valiente:a , a los enérgicos;enérgico:a , a los vencedores;vencedor:n , a quienes vencieron;vencer:v a pesar;*:n|*:v de todo;*:a .	arandu;*:n rekávo;<heka+vo:s|<heka:n tekotevẽ;<hekotevẽ:n rejesareko;jesareko:v umi imbaretévare;mbarete:n|mbarete:v , umi ikatupyrývare;katupyry:v , eha'ã;ha'ã:v umi ipy'aguasúvape;py'aguasu:v , umi ipyapývape;pyapy:n , umi akóinte itenondevévape , umi heko'apysẽva'ekue opaite;*|opa:n|pa:v mba'erasýgui .
piensa;pensar:v menos;*:n en los problemas;problema:n y más en tu trabajo;trabajar:v|*:n y los problemas;problema:n sin alimento;*:n|alimentar:v morirán;morir:v .	ani rejepy'apyeterei;jepy'apy:v umi ne;nde:n apañuãire , emombareteve;mombarete:v uvei ne;nde:n rembiapo;<hembiapo:n ha rehechakuaáta;<hecha:v mba'éichapa;*|mba'e:n umi apañuãi oguéta;gue:v ijehegui .
aprende;aprender:v a nacer;*:v desde el dolor;*:n y a ser;*:n|*:v grande;*:a , que es;ser:v el más grande;*:a de los obstáculos;obstáculo:n .	akóinte nereñoijeyva'erã;<heñói:v opaite;*|opa:n|pa:v mba'erasy rehasava'ekuégui;<hasa:v ha emombaretévo;mombarete:v (vo) jerovia;rovia:n|*:n ndejehe remokechẽta taha'eha'éva mba'evaípe .
mírate al espejo;*:n de ti mismo;*:a : comienza;comenzar:v a ser;*:n|*:v sincero;*:a contigo mismo;*:a reconociéndote;reconocer:v (te) por tu valor;*:n , por tu voluntad;*:n y por tu debilidad;*:n para justificarte .	emaña;maña:v ndejehe ha embohysýi umi mba'e;*:n nemombaretéva;mombarete:v : nde;*|*:n rekopu'aka , ne;nde:n rembipota;<hembipota:n ha ne;nde:n py'akangy reikuaa;kuaa:v porã;po:n haĝua mávapa;máva:n|máva+pa:s nde;*|*:n .
recuerda;recordar:v que dentro de ti hay una;uno:n|un:a|unir:v fuerza;*:n|forzar:v que todo;*:a puede;poder:v hacerlo;hacer:v (lo) , reconociéndote;reconocer:v (te) a ti más libre;*:a|*:n|librar:v y más fuerte;*:a|*:n dejarás;dejar:v de ser;*:n|*:v un;*:a títere;*:n de las circunstancias;circunstancia:n , porque tú eres tu destino;destinar:v|*:n .	nemandu'ava'erã;mandu'a:v ndepype;nde:n oĩha;ĩ:v pu'aka;*:n ijojaha'ỹva;jojaha'ỹva:v|joja:n|jojaha:n opaite;*|opa:n|pa:v mba'e;*:n apoharã;apo:n|po:v ; reikuaaporãvo;kuaa:v (vo) nde;*|*:n rekosãsoha ha ikatuha;katu:n|katu:v ndepu'aka;pu'aka:v opaite;*|opa:n|pa:v mba'ére;mba'e:n , nde;*|*:n ndaha'emo'ãvéima po'a;*:n|'a:v rembipuru nde;*|*:n ha'égui;'e:v nde;*|*:n rekove;<heko:n|<hekove:n renonderã;<henonde:n jára;*:n .
y nadie puede;poder:v sustituirte;sustituir:v (te) en la construcción;*:n de tu propio;*:a|*:n destino;destinar:v|*:n .	ha avave;va:v|ava:n ndaikatúi;katu:v nemyengovia nde;*|*:n rekove;<heko:n|<hekove:n renonderã;<henonde:n apópe;apo:n|po:v .
levántate y mira;*:n|mirar:v por las montañas;montaña:n y respira;respirar:v la luz;*:n del amanecer;*:n|*:v , tú eres parte;partir:v|*:n de la fuerza;*:n|forzar:v de la vida;*:n .	epu'ã;pu'ã:v ha ejesareko;jesareko:v yvytyrusúre ha nepytuhẽke arasẽ pýri , nde;*|*:n ha'égui;'e:v tekove;<heko:n|<hekove:n mbarete;*:n pytu;*:n .
ahora despierta;despierto:a|despertar:v , camina;caminar:v , lucha;*:n|luchar:v , decídete y triunfarás;triunfar:v en la vida;*:n .	upévare;upe:n , epáy;páy:v , eguata;guata:v , eñorairõ;ñorairõ:v ha katuete netenondéta ko arapýpe;ára:n|arapy:n .
nunca pienses;pensar:v en la suerte;*:n , por que la suerte;*:n es;ser:v el pretexto;*:n de los fracasados;fracasar:v .	ani rejeko;ko:v po'áre;po'a:n|'a:v , péva;*|pe:n|*:n akóinte oĩgui;ĩ:v umi ipy'amirĩva;py'amirĩ:v rekopýpe;<heko:n|reko:n .
hace;hacer:v más de tres;*:a|*:n millones;millón:n de años;año:n , los ancestros de los humanos;humano:a|humano:n caminaban;caminar:v erguidos;erguido:a|erguir:v pero;*|*:n todavía eran;ser:v capaces;capaz:a de trepar;*:v a los árboles;árbol:n como;*|comer:v los monos;mono:n , indicó;indicar:v un;*:a estudio;estudiar:v|*:n publicado;publicar:v en la revista;revestir:v|*:n “ Science ” de EE . UU .	haimete mbohapy;*:n sua ary;*:n rasami , ava;va:v|*:n ypykue;ypy:n|y:n oguata;guata:v ñembo'yhápe;ñembo'y:n jepérõ;pe+rõ:s|pe:n oikokuaa;ko:v|iko:v yvyra;*:n rakãre;<hakã:n ka'ikuéraicha;ka'i:n , péicha;*|pe:n he'i;'e:v peteĩ;*:n tembiapo;<hembiapo:n omyasãiva kuatihaipyre “ Science ” Estados Unidos - gua;*:n .
dos;*:a|*:n omóplatos extremadamente bien;*|*:a|*:n preservados;preservar:v de un;*:a homínido similar;*:a a la famosa;famoso:a Lucy , el primer;primero:a ancestro bípedo conocido;conocer:v|*:a|*:n del homo sapiens que cuenta;contar:v|*:n con 3,5 millones;millón:n de años;año:n , muestran;mostrar:v que esta especie;especiar:v|*:n continuaba;continuar:v también viviendo;vivir:v en los árboles;árbol:n , según la investigación;*:n .	mokõi;*:n ati'ykãngue oñeñongatuporãitereíva;ñongatu:v , ava'i;ava:n ypykue;ypy:n|y:n mba'e;*:n , Lucy joguaha;jogua:n , ha'éva;'e:v|ha'e:n ava;va:v|*:n ypykue;ypy:n|y:n oguatáva;guata:v ipýre;py:n , itujavéva;tuja:v , ko'áĝa peve;*|pe:n ojekuaáva;jekuaa:v|kuaa:v , orekóva;ko:v 3,5 sua ary;*:n ; omyesakã ko tekove;<heko:n|<hekove:n oikohague;ko:v|iko:v gueterei yvyrakuéra;yvyra:n ru'ãre;<hu'ã:n , péicha;*|pe:n he'i;'e:v tembikuaareka .
los dos;*:a|*:n omóplatos fosilizados;fosilizar:v de una;uno:n|un:a|unir:v niña;*:n australopithecus afarensis , la especie;especiar:v|*:n a la que pertenece;pertenecer:v Lucy , indican;indicar:v por primera;primero:a|*:n vez;*:n que estos homínidos;homínido:n estaban;estar:v bien;*|*:a|*:n adaptados;adaptar:v morfológicamente para trepar;*:v a las ramas;rama:n .	umi mokõi;*:n ati'ykãngue ha'éva;'e:v|ha'e:n peteĩ;*:n mitãkuña'i;mitãkuña:n australopithecus afarensis mba'e;*:n , Lucy rehegua , ko'áĝa ae ohechauka;<hecha:v|<hechauka:v porã;po:n umi ava'i;ava:n rete;<hete:n okakuaahaguevoi oiko;ko:v|iko:v haĝua yvyráre;yvyra:n .
el esqueleto;*:n completo;completar:v|*:a|*:n de uno;*:n|unir:v de ellos que vivió;vivir:v hace;hacer:v 3,3 millones;millón:n de años;año:n , bautizado como;*|comer:v “ Selam ”, fue;ir:v|ser:v descubierto;descubrir:v|*:a|*:n en el año;*:n 2000 en Etiopía .	peteĩva;peteĩ:n retekue;<hetekue:n|<hete:n umíva rehegua oikova'ekue;ko:v|iko:v 3,3 sua ary;*:n , oñembohérava;<héra:v “ Selam ”, ojejuhúkuri;juhu+kuri:v|juhu:v|jejuhu+kuri:v|jejuhu:v ary;*:n 2000- pe;*|*:n , Etiopía retãme;<hetã:n .
“ La cuestión;*:n sobre;*|sobrar:v|*:n si el australopithecus - cuyo primer;primero:a espécimen , Lucy , fue;ir:v|ser:v descubierto;descubrir:v|*:a|*:n en 1974 en Etiopía - era;*:n|ser:v estrictamente bípedo o continuó;continuar:v evolucionando;evolucionar:v en los árboles;árbol:n , era;*:n|ser:v objeto;*:n|objetar:v de debate;*:n|debatir:v desde hace;hacer:v 30 años;año:n ”, explicó;explicar:v David Green , profesor;*:n de paleobiología de la Universidad Midwestern en Illinois , uno;*:n|unir:v de los principales autores de estos trabajos;trabajo:n .	“ Australopithecus - Lucy ha'éva;'e:v|ha'e:n tenondere;<henonde:n umíva apytépe;*|apyte:n , ojejuhuva'ekue;juhu:v|jejuhu:v ary;*:n 1974- pe;*|*:n , Etiopía - pe;*|*:n - oguatavavoíntepa;guata+pa:v mokõive;mokõi:n ipýre;py:n térãpa oiko;ko:v|iko:v jave;*|ja:n yvyráre;yvyra:n ombokatupyryvékuri hete;<hete:n , niko peteĩ;*:n myangekói;*:n orekómava;ko:v 30 ary;*:n rasami ”, he'i;'e:v David Green , mbo'ehára;*:n|mbo'e:n tekoveymakuaaty rehegua Midwestern Mbo'ehaovusúpe , opytáva;pyta:v Illinois - pe;*|*:n ha ha'éva;'e:v|ha'e:n tembikuaarekahára ojepytasombaretevéva ko tembiapópe;<hembiapo:n .
“ Estos omóplatos fosilizados;fosilizar:v proporcionan;proporcionar:v una;uno:n|un:a|unir:v sólida;sólido:a indicación;*:n de que estos individuos;individuo:n continuaban;continuar:v trepando;trepar:v en los árboles;árbol:n en este;*:n estadio;*:n de la evolución;*:n humana;humano:a ”, añadió;añadir:v .	ko'ã;*|*:n ati'ykãngue itapýpe;ita:n|tapy:n opytáva;pyta:v ohechauka;<hecha:v|<hechauka:v ko'ã;*|*:n tekove;<heko:n|<hekove:n , jepémo oguatáma;guata:v mokõive;mokõi:n ipýre;py:n , oikohague;ko:v|iko:v gueterei hikuái - ápe;*|a:n ha pépe;pe:n - yvyrakuéra;yvyra:n rakãre;<hakã:n ”, ombojoapy;mbojoapy:v .
“ Trepaban para escapar;*:v de depredadores;depredador:n o por comida;comer:v|*:n ”, subrayó;subrayar:v .	ojupi;jupi:v hikuái yvyráre;yvyra:n ojehekýi;jehekýi:v|<hekýi:v haĝua ambue;*:n mymba;*:n ñarõgui térã tembi'u;<hembi'u:n piári ”, omyesakã .
“ Cuando comparamos;comparar:v el omóplato de la niña;*:n australopithecus a los miembros;miembro:n adultos;adulto:a|adulto:n de la misma;mismo:a especie;especiar:v|*:n , era;*:n|ser:v evidente;*:a que las características;característica:n de desarrollo;desarrollar:v|*:n se emparentan más a las del mono;*:n ”, explica;explicar:v .	“ Ñambohovake jave;*|ja:n pe;*|*:n mitãkuña'i;mitãkuña:n australopithecus ati'ykãngue peteĩva;peteĩ:n ñande;*|*:n reheguávare , jahechakuaa;<hecha:v pe;*|*:n tete;<hete:n jepokuaa;*:n ojoguaveha;jogua:v ka'ikuéra;ka'i:n rete;<hete:n jepokuaápe;jepokuaa:n ”, omyesakã .
el australopithecus afarensis representa;representar:v en la evolución;*:n una;uno:n|un:a|unir:v nueva;*:n|nuevo:a especie;especiar:v|*:n de homínidos;homínido:n , muy diferente;*:a a la precedente;*:n .	australophitecus Afarensis ha'ehína tekove;<heko:n|<hekove:n pyahu avakuéra;ava:n|áva:n apytépe;*|apyte:n , ojoavýva;joavy:v imboyveguágui;mboyvegua:v .
en varios;vario:a países;país:n , el día;*:n 14 de febrero;*:n se celebra;celebrar:v el DÍA DE LOS ENAMORADOS , también conocido;conocer:v|*:a|*:n como;*|comer:v DÍA DEL AMOR .	heta;<heta:v tetãme;<hetã:n , ára;*:n 14 jasykõi;*:n jave;*|ja:n , ojegueromandu'a OJOHAYHÚVA ÁRA , avei oñembohérava;<héra:v MBORAYHU ÁRA .
todos;todo:a los que vivimos;vivir:v en este;*:n mundo;*:n amamos;amar:v a alguien y lo demostramos;demostrar:v de varias;vario:a maneras;manera:n : con mimos;mimo:n , besos;beso:n , lágrimas;lágrima:n , sonrisas;sonrisa:n , con un;*:a apretón;*:n de manos;mano:n , abrazos;abrazo:n , canciones;canción:n , poesías o regalos;regar+los:v|regalo:n .	tekove;<heko:n|<hekove:n ñaimemíva;ime:v guive ko yvórape niko japorohayhu;<hayhu:v ha jahechauka;<hecha:v|<hechauka:v upe;*|*:n mba'e;*:n guasuete heta;<heta:v hendáicha;<henda:n : kunu'ũ;*:n , ñehetũ;*:n , tesay;<hesay:n , pukavy;*:n , popyhy;pyhy:v , añuã;ñuã:v , purahéi , ñe'ẽpoty térã jopói;*:n rupive;<hupi:n .
el amor;*:n se siente;sentar:v|sentir:v .	mborayhu;*:n niko ñañandu;<ñandu:v .
cuando él nos envuelve;envolver:v sentimos;sentir:v más intensos;intenso:a y acelarados los latidos;latido:n|latir:v del corazón;*:n ; asimismo , nos sentimos;sentir:v más contentos;contento:a|contento:n y más animados;animar:v .	ha'e;*|'e:v|*:n ñande'aho'i jave;*|ja:n niko ñaimo'ãvoi;ñaimo'ã:n|imo'ã+voi:v|imo'ã:v|ñaimo'ã+voi:s ñane;ñande:n korasõ;*:n opepe;pepe:v hatãve;<hatã:n|<hatã:v ha pya'evéva ; upéicha;upe:n avei , ñanderoryve;<hory:v ha ñandepireporãve .
de hecho;hacer:v|*:a|*:n no existe;existir:v algo más bello;*:a que la demostración;*:n del amor;*:n .	ndaiporichéne mba'e;*:n iporãvéva;porã:v mborayhu;*:n jehechaukágui .
inicialmente amamos;amar:v a nuestra madre;*:n y a nuestro padre;*:n , luego a nuestros amigos;amigo:n y más adelante;adelantar:v buscamos;buscar:v , hasta encontrar;*:v , a la dueña;*:n o dueño;*:n de nuestro amor;*:n a quien unimos;unir:v nuestra vida;*:n de ser;*:n|*:v posible;*:a hasta la muerte;*:n .	ñepyrũrãme;pyrũ:n jahayhu;<hayhu:v ñande;*|*:n sy;*:n ha ñande;*|*:n rúpe , upéi ñane;ñande:n angirũmimíme ha tenondeve;<henonde:n gotyo jaheka;<heka:v ha jajuhu;juhu:v peteĩ;*:n mborayhu;*:n jára;*:n ha hendive;ha'e:n ñambojoaju;mbojoaju:v ñande;*|*:n rekove;<heko:n|<hekove:n ikatúramo;katu:v (ramo) ñamano;mano:v meve;*|me:n .
igualmente , el 14 de febrero;*:n se recuerda;recordar:v el día;*:n de San Valentín , quien vivió;vivir:v en Roma , hacia el año;*:n 300 después de Cristo .	upéicha;upe:n avei 14 jasykõi;*:n ojegueromandu'a Valentín Marangatu ára;*:n , oikova'ekue;ko:v|iko:v Roma - pe;*|*:n , ary;*:n 300 rasami rupi;*|<hupi:n , Hesukirito rire .
el Papa Gelasio I , cabeza;*:n de la Iglesia Catolica Romana , fue;ir:v|ser:v quien inició;iniciar:v en el año;*:n 498 la celebración;*:n del día;*:n de San Valentín que sigue;seguir:v vigente;*:a hasta hoy .	avarepavẽ Gelasio I , Kirito Tupão motenondehára , ndaje upe;*|*:n omoñepyrũva'ekue pe;*|*:n arete;a:n|*:n Valentín rérape;<héra:n ary;*:n 498- pe;*|*:n ha upe;*|*:n guive ojejapójepi;<japo:v pe;*|*:n vy'aguasu hérape;<héra:n|<héra:v .
cuentan;contar:v que Valentín casaba;casar:v a escondidas;esconder:v|escondido:a a los enamorados;enamorar:v|enamorado:n|enamorado:a de su tiempo;*:n debido;deber:v a la prohibición;*:n del casamiento resuelta;resolver:v|resuelto:a por el Emperador Claudio II .	valentín ndaje omomendámi;menda:v ñemiháme umi ojohayhúvape;<hayhu:v ; Claudio II , Roma myakãhára uperõgua , ndoipotavéikuri;pota+kuri:v|potave+kuri:v|pota:v|potave:v oiko;ko:v|iko:v ñemenda;menda:n .
valentín fue;ir:v|ser:v ejecutado;ejecutar:v un;*:a 14 de febrero;*:n que quedó;quedar:v - desde entonces - como;*|comer:v el día;*:n de los enamorados;enamorar:v|enamorado:n|enamorado:a .	valentín ojejukákuri;juka+kuri:v|juka:v peteĩ;*:n ára;*:n 14 jasykõi;*:n , opytáva;pyta:v - upe;*|*:n guive - ojohayhúva;<hayhu:v árarõ;ára:n|ára+rõ:s .
otros;otro:n|otro:a dicen;decir:v que febrero;*:n es;ser:v el mes;*:n del amor;*:n ya que en su transcurso;*:n las aves;ave:n se emparejan;emparejar:v y procrean;procrear:v .	oĩ;ĩ:v avei he'íva;'e:v kóva;*|*:n ha'eha;'e:v mborayhu;*:n jasy;*:n guyrakuéra;guyra:n oñemoñavégui;ñemoña:v|moña:v ko jasýpe;jasy:n .
el día;*:n 23 de febrero;*:n del año;*:n 1905 nacía;nacer:v en los Estados Unidos , hace;hacer:v poco;*:a|*:n más de 100 años;año:n , la mayor;*:a|*:n organización;*:n internacional;*:n de servicio;*:n de caracter no gubernamental , no político;*:n y no religioso;*:n : el ROTARY CLUB .	ára;*:n 23 jasykõi;*:n ary;*:n 1905- pe;*|*:n heñóikuri Estados Unidos retãme;<hetã:n , ojapóma;<japo:v 100 ary;*:n rasami , pe;*|*:n aty;*:n jekupytyguigua tuichavéva ko yvy;*:n ape;*:n ári , noĩriva tetã;<hetã:n poguýpe;guy:v , noporomboykéiva;mboyke:v sa'y;*:n térã jeroviakatúre , ha'éva;'e:v|ha'e:n ROTARY CLUB .
su nacimiento;*:n se debió;deber:v a la iniciativa;*:n de un;*:a joven;*:a|*:n y visionario;*:n abogado;*:n de Wisconsin llamado;llamar:v|*:a Paul Percy Harris , quien junto;juntar:v|*:a a tres;*:a|*:n amigos;amigo:n decide;decidir:v constituir;*:v un;*:a 23 de febrero;*:n de 1905, en el convulsionado;convulsionar:v clima;*:n de la ciudad;*:n de Chicago de entonces , un;*:a club;*:n distinto;*:a a todos;todo:a los existentes .	ko atyha;aty:n guasuete omoheñoiva'ekue;<heñói:v peteĩ;*:n mitãrusu;*:n tekomo'ãhára hesapysóva , Wisconsin - ygua;y:n|*:n , hérava;<héra:n|<héra:v Paul Percy Harris ; ha'e;*|'e:v|*:n ha mbohapy;*:n iñangirũ;angirũ:n omoañetékuri peteĩ;*:n ára;*:n 23 jasykõi;*:n ary;*:n 1905- pe;*|*:n , táva;*:n Chicago - pe;*|*:n , peteĩ;*:n atyha;aty:n tuicha ojoavýva;joavy:v umi ambuégui;ambue:n .
no se trataba;tratar:v de un;*:a club;*:n deportivo;*:n , ni de un;*:a club;*:n social , ni siquiera de una;uno:n|un:a|unir:v entidad;*:n de beneficencia;*:n , constituyeron;constituir:v el primer;primero:a CLUB de SERVICIO del mundo;*:n .	ko ha'ekuéra;*|ha'e:n omoheñóiva;<heñói:v niko ndaha'éi tetemongu'erã atyha;aty:n añónte , ndaha'ei avano'õrã atyha;aty:n añónte , ndaha'éi ñepytyvõrã;pytyvõ:n|ñepytyvõ:n atyha;aty:n añónte , kóva;*|*:n niko ha'ehína atyha;aty:n peteĩha;peteĩ:n jekupytyguigua ko yvórape .
formarían;formar:v parte;partir:v|*:n del mismo;*:a , profesionales;profesional:n y hombres;hombre:n de negocios;negocio:n destacados;destacar:v por su honorabilidad;*:n , su vocación;*:n de servicio;*:n y su liderazgo;*:n en sus respectivas actividades;actividad:n .	upépe;upe:n ijákuri;ja:v|ja+kuri:v iñepyrũhá guive mba'apohára;mba'apo:n katupyry ha kuimba'e;*:n omba'apóva;mba'apo:v opaichagua;opa:n mba'erepy;*:n ñemúme;ñemu:n , hekopotĩva , ohechakuaáva;<hecha:v hapicha;<hapicha:n remikotevẽ ha akóinte itenondevéva hekohápe;<heko:n|<hekoha:n .
al poco;*:a|*:n tiempo;*:n , ese club;*:n constituido;constituir:v en Chicago comenzó;comenzar:v a expandir;*:v sus actividades;actividad:n con la creación;*:n de entidades;entidad:n similares;similar:a en todo;*:a Estados Unidos y en 1911 traspone por primera;primero:a|*:n vez;*:n sus fronteras;frontera:n y se instala;instar+la:v|instalar:v el primer;primero:a club;*:n rotario en Winnipeg , Canadá .	uperiremínte , upe;*|*:n atyha;aty:n oñepyrũva;pyrũ:v|ñepyrũ:v Chicago - pe;*|*:n okakuaave;kakuaa:v ha upéicha;upe:n rupi;*|<hupi:n oñemoheñói;<heñói:v heta;<heta:v atyha;aty:n heseguaite ambue;*:n táva;*:n Estados Unidos - guápe;gua:n ha ary;*:n 1911- pe;*|*:n oñemoheñói;<heñói:v peteĩ;*:n atyha;aty:n Rotary rehegua ambue;*:n tetãme;<hetã:n ; Táva Winnipeg , Canadá retãme;<hetã:n .
siguieron;seguir:v luego clubes;club:n rotarios en Inglaterra , Irlanda , y Escocia .	upéi Rotary okakuaave;kakuaa:v ha oñemyasãi;myasãi:v atyha;aty:n hesegua Inglaterra , Irlanda ha Escocia - pe;*|*:n .
el rápido;*:a|*:n crecimiento;*:n del movimiento;*:n rotario en el mundo;*:n excedió;exceder:v la imaginación;*:n de su propio;*:a|*:n creador;*:n .	pya'etereíniko;pya'e:n okakuaa;kakuaa:v Rotary ñemongu'e ko yvórape ha ijapoharépe;apo:n jepe;*|pe:n ohesarea .
aparecieron;aparecer:v clubes;club:n rotarios por todas;todo:a partes;parte:n y fue;ir:v|ser:v así;*|asir:v , que en su rápida;rápido:a expansión;*:n por el mundo;*:n , en el año;*:n 1918 Rotary llega;llegar:v al Río de la Plata fundándose;fundar:v (se) el primer;primero:a club;*:n rotario de Sudamérica , el Rotary Club de Montevideo .	oparupirei oñemopu'ã;pu'ã:v Rotary atyha;aty:n ha peichahápe herakuã mbarete;*:n ko yvorapýpe ha ary;*:n 1918- pe;*|*:n Rotary oĝuahẽ;guahẽ:v Río de la Plata - pe;*|*:n ha upevakuére oñemoheñói;<heñói:v Rotary Atyha peteĩha;peteĩ:n Sudamérica - pe;*|*:n , ha'éva;'e:v|ha'e:n Rotary Atyha Montevideo - gua;*:n .
le siguieron;seguir:v luego Buenos Aires (1920), Río de Janeiro (1923) y Santiago de Chile (1925).	upéi , Buenos Aires (1920), Río de Janeiro (1923), ha Santiago de Chile (1925).
un;*:a 28 de noviembre;*:n del año;*:n 1927 un;*:a grupo;*:n de veinticinco destacados;destacar:v líderes;líder:n de nuestra comunidad;*:n funda;fundar:v|*:n|fundir:v el Rotary Club de Asunción , primer;primero:a club;*:n rotario del Paraguay .	ára;*:n 28 jasypateĩ;*:n ary;*:n 1927- pe;*|*:n peteĩ;*:n aty;*:n oĩháme tekove;<heko:n|<hekove:n joheipyre tava;va:v guasu;*:n Paraguaygua;paraguay:n , omoheñóikuri;<heñói:v|<heñói+kuri:v Rotary Atyha Paraguaýgua , ha'éva;'e:v|ha'e:n Rotary Atyha peteĩha;peteĩ:n Paraguay;paraguay:n retãme;<hetã:n .
entre;*|entrar:v sus fundadores;fundador:n se encontraban;encontrar:v el Dr . Zoilo Díaz Escobar , su primer;primero:a presidente;*:n , Quinto Censi , Manfredo Russo , Teodoro Malbrane , Rogelio Livieres , Eliseo Da Rosa , Manuel Ferreira , Hipólito Sánchez , José Rodríguez Alcalá , Tomas Osuna , Máximo Croskey , Víctor Abente Haedo y otros;otro:n|otro:a más .	umi imopu'ãhare;mopu'ãha:n apytépe;*|apyte:n jajuhukuaa;juhu:v karai;*:n Zoilo Díaz Escobar , ha'eva'ekue;'e:v imotenondehára peteĩha;peteĩ:n , Quinto Censi , Manfredo Russo , Teodoro Malbrane , Rogelio Livieres , Eliseo Da Rosa , Manuel Ferreira , Hipólito Sánchez , José Rodríguez Alcalá , Tomás Osuna , Máximo Croskey , Víctor Abente Haedo ha ambue;*:n .
a la fundación;*:n del RC de Asunción le siguieron;seguir:v luego Villarrica (1929), Concepción (1939), Encarnación (1940), y otros;otro:n|otro:a que componen;componer:v hoy los veintiun clubes;club:n rotarios del Paraguay .	rotary Atyha Táva Paraguay;paraguay:n rire oñemopu'ãkuri;pu'ã+kuri:v|pu'ã:v Villarrica (1929), Concepción (1939), Encarnación (1940), ha ambuéva;ambue:n ; ko'aĝaite jaguereko;reko:v 21 Rotary Atyha Paraguay;paraguay:n retãme;<hetã:n .
rotary es;ser:v una;uno:n|un:a|unir:v organización;*:n de líderes;líder:n de negocios;negocio:n y profesionales;profesional:n unidos;unido:a|unir:v mundialmente con el propósito;*:n de prestar;*:v servicio;*:n humanitario , alentar;*:v elevadas;elevado:a|elevar:v normas;norma:n de ética;ético:a|*:n en los negocios;negocio:n y profesiones;profesión:n y contribuir;*:v al desarrollo;desarrollar:v|*:n de la buena;bueno:a voluntad;*:n y la paz;*:n en el mundo;*:n .	rotary niko peteĩ;*:n atyha;aty:n ono'õ;no'õ:v háme tekove;<heko:n|<hekove:n poravopyre;poravo:n omba'apóva;mba'apo:v mba'erepy;*:n ñemúme;ñemu:n , mba'apohára;mba'apo:n katupyry ko yvoragua , ojoajupáva hikuái omoañete haĝua opaichagua;opa:n jekupytyrã , omyasãi;myasãi:v haĝua tekopotĩ mba'erepy;*:n ñemúme;ñemu:n ha ambue;*:n tembiapópe;<hembiapo:n ha oipytyvõ;pytyvõ:v haĝua tapicha;<hapicha:n jehechakuaápe ha py'aguapy;*:n ñemombaretépe;momba:n|mombarete:n , ko yvy;*:n ape;*:n ári .
rotary congrega;congregar:v a hombres;hombre:n y mujeres;mujer:n de todas;todo:a las razas;raza:n , credos;credo:n religiosos;religioso:n e ideas;idea:n políticas;política:n , en el marco;*:n|marcar:v de un;*:a ambiente;*:n amistoso , democrático e imparcial;*:a .	rotary - pe;*|*:n ijaty;aty:n kuimba'e;*:n ha kuña;*:n ipire;pire:n morotĩ , sa'yju térã hũva , ijeroviakatujoavýva ha isa'y;sa'y:n opaichaguáva , ojohayhu;<hayhu:v , ojohecharamo;<hecha:v ha omba'apóva;mba'apo:v hikuái tekoayhu;<hekoayhu:n , tekojoja;<hekojoja:n ha tekopeteĩme .
los lazos;lazo:n de compañerismo;*:n y amistad;*:n constituyen;constituir:v la plataforma;*:n desde donde se genera;generar:v el servicio;*:n a los demás , a través;*:n de actividades;actividad:n que los rotarios cumplen;cumplir:v en el terreno;*:n personal;*:n , profesional;*:n y de servicio;*:n a la comunidad;*:n .	pe;*|*:n irũ;*:n reko;<heko:n ha tekoayhu;<hekoayhu:n heñoiva ijapytepekuéra ha'e;*|'e:v|*:n pe;*|*:n omombaretéva;mombarete:v chupekuéra;ha'e:n oipytyvõ;pytyvõ:v haĝua ambue;*:n oikotevẽvape opaichagua;opa:n tembiapo;<hembiapo:n rupive;<hupi:n , ha'ekuéra;*|ha'e:n ojapóva;<japo:v peteĩteĩ , mba'apoháraicha;mba'apo:n ha ohechakuaávo;<hecha:v (vo) hekohápe;<heko:n|<hekoha:n .
desde sus albores Rotary se ha;haber:v destacado;destacar:v por su afán;*:n de lograr;*:v el entendimiento;*:n y la buena;bueno:a voluntad;*:n entre;*|entrar:v los pueblos;pueblo:n de la tierra;*:n , fomentando;fomentar:v el diálogo;*:n y creando;crear:v las condiciones;condición:n para la resolución;*:n de los conflictos;conflicto:n .	iñepyrũha;ñepyrũ:n guive Rotary oñeha'ãkuri;ñeha'ã+kuri:v|ha'ã:v|ha'ã+kuri:v|ñeha'ã:v ohupyty;<hupyty:v pe;*|*:n jeiko;iko:n peteĩ;*:n ñe'ẽme;ñe'ẽ:n ha py'amarangatúpe opaite;*|opa:n|pa:v tetã;<hetã:n rupi;*|<hupi:n ha upevarã omombarete;mombarete:v pe;*|*:n ñomongeta;*:n ha oheka;<heka:v mba'éichapa;*|mba'e:n ikatu;katu:v oñembogue;gue:v opaichagua;opa:n ñeko'õi;ko'õi:n|*:n .
“ DAR DE SÍ ANTES DE PENSAR EN SÍ ”, ha;haber:v sido;ser:v el lema;*:n que ha;haber:v guiado a los rotarios de todo;*:a el mundo;*:n durante toda;todo:a su historia;*:n .	“ EME'Ẽ NDEJEHEGUI EJEPY'APY MBOYVE NDEJEHE ”, ha'ehína ñe'ẽporavopyre oisãmbyhýva;sãmbyhy:v Rotariokuérape ymaite guive ko'aĝaite peve;*|pe:n .
rotary reune hoy a más de 1.200.000 hombres;hombre:n y mujeres;mujer:n ( ingresadas;ingresar:v a la organización;*:n en 1986), que trabajan;trabajar:v en 166 países;país:n con el objetivo;*:n de estimular;*:v y fomentar;*:v el ideal;*:n de servicio;*:n como;*|comer:v base;basar:v|*:n de toda;todo:a empresa;*:n digna;digno:a .	rotary - pe;*|*:n ijaty;aty:n 1.200.000 rasami kuimba'e;*:n ha kuña;*:n ( ijañepyrũva;ja:v Rotary atyhápe;aty:n ary;*:n 1986 guive ), omba'apóva;mba'apo:v 166 tetãme;<hetã:n oñeha'ãva;ha'ã:v|ñeha'ã:v hikuái omombarete;mombarete:v jekupyty reko;<heko:n taha'eha'éva mba'erepyñemurã hekopotĩvape .
pasaron;pasar:v por sus filas;fila:n destacadas;destacar:v personalidades;personalidad:n del mundo;*:n entre;*|entrar:v los que se pueden;poder:v citar;*:v a : Sir Winston Churchill , Michel Debré , Walt Disney , Thomas Alba Edison , John F . Kennedy , Thomas Mann , el Príncipe Reiniero de Mónaco , Franklin D . Roosvelt , Albert Schweitzer , Margaret Tatcher , Neil Amstrong , Fernando Belaunde Terry , Franz Lehard y muchos;mucho:a más .	rotary Atyha rupive;<hupi:n niko ohasajepe;<hasa:v heteitereí tapicha;<hapicha:n iñarandu;arandu:n ha ikatupyrýva;katupyry:v ha hekove;<heko:n|<hekove:n opytáva;pyta:v mandu'arã;mandu'a:n , péicha;*|pe:n : Karai Winston Churchill , Michel Debré , Walt Disney , Thomas Alba Edison , John F . Kennedy , Thomas Mann , el Príncipe Reiniero de Mónaco , Franklin D . Roosvelt , Albert Schweitzer , Margaret Tatcher , Neil Amstrong , Fernando Belaunde Terry , Franz Lehard ha hetave;<heta:v .
el libro;*:n|librar:v “ Un Siglo de Servicio ” - publicado;publicar:v con motivo;motivar:v|*:n del Centenario de Rotary en el año;*:n 2005- distingue;distinguir:v entre;*|entrar:v cien;*:a|*:n rotarios destacados;destacar:v del mundo;*:n a dos;*:a|*:n rotarios paraguayos : el Dr . Eusebio Ayala y el Dr . Raúl Sapena Pastor .	aranduka “ Un Siglo de Servicio ”- pe;*|*:n - oñonohẽva'ekue , ary;*:n 2005- pe;*|*:n , oñemomorãrõguare;momorã:v (ramo+guare) Rotary sa ary;*:n - oñemyasãi;myasãi:v 100 Rotario poravopyre;poravo:n ko yvy;*:n ape;*:n arigua rekovekue;<hekove:n ha umíva apytépe;*|apyte:n jajuhukua mokõi;*:n rotario ñane;ñande:n retãyguáva;<hetãygua:n , ha'éva;'e:v|ha'e:n : Eusebio Ayala ha Raúl Sapena Pastor .
este;*:n hecho;hacer:v|*:a|*:n llena;lleno:a|llenar:v de orgullo;*:n a los rotarios paraguayos .	ko mba'e;*:n ñanembovy'ava'erã;vy'a:v opavavépe .
su nombre;*:n|nombrar:v completo;completar:v|*:a|*:n es;ser:v Víctor Marie Hugo , nació;nacer:v el día;*:n 26 de febrero;*:n del año;*:n 1802, en Besanzón , Francia .	hera tee niko Víctor Marie Hugo , heñóikuri ára;*:n 26 jasykõi;*:n ary;*:n 1802- pe;*|*:n , Besanzón , Francia retãme;<hetã:n .
su padre;*:n fue;ir:v|ser:v Joseph Leopold Sigisbert Hugo y su madre;*:n Sophie Trebuchet .	itúva;ru:n herava'ekue;<héra:v Joseph Leopold Sigisbert Hugo ha isýkatu;sy:n Sophie Trebuchet .
víctor pasó;pasar:v tu infancia;*:n en Paris y también en Madrid y Nápoles .	imitãme;mitã:n|mitã:v Víctor oikókuri;iko+kuri:v|ko:v|ko+kuri:v|iko:v París - pe;*|*:n ha upéicha;upe:n avei Madrid ha Napoles - pe;*|*:n .
luego , su madre;*:n se separó;separar:v de su padre;*:n y se relacionó;relacionar:v con Victor Lahorie , su nuevo;*:a|*:n amor;*:n .	upéi , isy;sy:n oheja;<heja:v itúvape;ru:n ha oikókuri;iko+kuri:v|ko:v|ko+kuri:v|iko:v Víctor Lahorie ndive , imborayhujára pyahu .
muy joven;*:a|*:n , hacia el año;*:n 1815, Víctor Hugo empezó;empezar:v a escribir;*:v sus primeros;primero:a versos;verso:n ( Cuaderno de versos;verso:n francés;*:n ).	imitãrusúpe;mitãrusu:n , ary;*:n 1815 rupi;*|<hupi:n , Víctor Hugo ohaiñepyrũkuri;hai+kuri:v|hai:v iñe'ẽpoty ypykue;ypy:n|y:n ( Francés ñe'ẽpoty ryru;*:n|<hyru:n ).
era;*:n|ser:v autodidacta , su madre;*:n y hermanos;hermano:n se encargaban;encargar:v de revisar;*:v sus obras;obra:n .	oñehekombo'e;<hekombo'e:v ijehegui , isy;sy:n ha ijoyke'ykuéra;joyke'y:n oha'ã;ha'ã:v hikuái umi hembiapokue;<hembiapo:n .
es;ser:v considerado;considerar:v|*:a como;*|comer:v uno;*:n|unir:v de los escritores;escritor:n más importantes;importante:a en Lengua Francesa .	oje'e;je'e:v hese;ha'e:n oĩha;ĩ:v umi haihára;hai:n|hái:n|*:n|<hái:n ikatupyryvéva;katupyry:v apytépe;*|apyte:n francés ñe'ẽme;ñe'ẽ:n .
los escritos;escribir:v|escrito:a|escrito:n de Víctor Hugo abarcaron;abarcar:v todos;todo:a los géneros;género:n hasta los discursos;discurso:n políticos;político:n .	víctor Hugo rembiapokue;<hembiapo:n apytépe;*|apyte:n jajuhukuaa;juhu:v opaichagua;opa:n haipyre;hai:n|*:n , polítikaguigua ñe'ẽsyry jepe;*|pe:n .
poeta;*:n , dramaturgo;*:n pero;*|*:n sobre;*|sobrar:v|*:n todo;*:a hombre;*:n comprometido;comprometer:v con la realidad;*:n social de su tiempo;*:n .	ñe'ẽpapára;*:n , ñoha'ãngahaihára ohechakuaa;<hecha:v ha oñandupypukúva hetãygua;<hetãygua:n|<hetã:n remikotevẽ .
sus obras;obra:n renovaron;renovar:v la literatura;*:n francesa .	umi hembiapo;<hembiapo:n ombopyahu;mbopyahu:v Francia ñe'ẽporãhaipyre;*:n .
la defensa;*:n de sus ideas;idea:n motivaron;motivar:v su exilio;exiliar:v|*:n por casi veinte;*:a|*:n años;año:n (1852 - 1870).	oikohague;ko:v|iko:v rupi;*|<hupi:n oipysyrómbaretékuri hemiandu;<hemiandu:n ha upe;*|*:n mba'ére;mba'e:n oñemosẽva'ekue;sẽ:v hetãgui;<hetã:n haimete mokõipa;mokõi:s (pa) ary;*:n (1852 – 1870).
algunas;alguno:a de sus obras;obra:n más importantes;importante:a son;*:n|ser:v “ Odas y Baladas (1826)”, “ Nuestra Señora de París (1831)”, “ Las hojas;hoja:n de otoño;*:n (1832)”, “ Los castigos;castigo:n (1853)”, “ Las contemplaciones;contemplación:n (1856)”, “ La leyenda;*:n de los siglos;siglo:n (1859 y 1877)” y “ Los miserables;miserable:n (1862)”.	umi hembiapokue;<hembiapo:n ojekuaavéva;jekuaa:v|kuaa:v apytépe;*|apyte:n oĩ;ĩ:v “ Odas y;*:n Baladas (1826)”, “ Nuestra Señora de París (1831)”, “ Las hojas de otoño (1832)”, “ Los castigos (1853)”, “ Las contemplaciones (1856)”, “ La leyenda de los siglos (1859 ha 1877)” ha “ Los miserables (1862)”.
víctor Hugo falleció;fallecer:v en la Ciudad de París , el día;*:n 22 de mayo;*:n del año;*:n 1885.	víctor Hugo omanókuri;mano+kuri:v|mano:v Táva París - pe;*|*:n , ára;*:n 22 jasypo;*:n ary;*:n 1885- pe;*|*:n .
fue;ir:v|ser:v sepultado;sepultar:v en el Panteón de Paris , el día;*:n 1 de junio;*:n del año;*:n 1885 con el acompañamiento;*:n de dos;*:a|*:n millones;millón:n de personas;persona:n que le rindieron;rendir:v un;*:a gran;grande:a homenaje;*:n .	oñeñotỹkuri;ñotỹ+kuri:v|ñotỹ:v Panteón de París - pe;*|*:n , ára;*:n 1 jasypoteĩ;*:n ary;*:n 1885- pe;*|*:n ha upérõ;upe:n|upe+rõ:s omoirũpahákuri chupe;ha'e:n mokõi;*:n sua tapicha;<hapicha:n ohechakuaa;<hecha:v ha omomba'eguasúva;momba'e:v|momba'eguasu:v hekove;<heko:n|<hekove:n .
el hombre;*:n es;ser:v la más elevada;elevado:a|elevar:v de las criaturas;criatura:n , La mujer;*:n el más sublime;*:a de los ideales;idear+les:v|ideal:n .	kuimba'e;*:n niko Tupã;tupã:n remimoĩngue tuichavéva , kuña;*:n katu temimo'ã imarangatuvéva;marangatu:v .
dios;*:n hizo;hacer:v para el hombre;*:n un;*:a trono;*:n ; para la mujer;*:n , un;*:a altar;*:n , el trono;*:n exalta;exaltar:v , el altar;*:n santifica;santificar:v .	tupã;*:n niko ojapókuri;<japo+kuri:v|<japo:v kuimba'épe;kuimba'e:n peteĩ;*:n apykaruvicha ; ha kuñáme;kuña:n katu peteĩ;*:n tendakatu , apykaruvicha ombotuicha;mbotuicha:v , tendakatu omomarangatu .
el hombre;*:n es;ser:v el cerebro;*:n ; la mujer;*:n , el corazón;*:n , el cerebro;*:n produce;producir:v Luz ; el corazón;*:n , amor;*:n ; la Luz fecunda;fecundo:a|fecundar:v ; el amor;*:n , resucita;resucitar:v .	kuimba'e;*:n niko apytu'ũ;*:n , kuña;*:n katu ñe'ã;*:n , apytu'ũme;apytu'ũ:n heñói tesape;<hesape:n , ñe'ãme;ñe'ã:n , mborayhu;*:n ; tesape;<hesape:n omoñemoña;ñemoña:v ; mborayhu;*:n , oporomoingovejey .
el hombre;*:n es;ser:v el genio;*:a|*:n ; la mujer;*:n , el ángel;*:n , el genio;*:a|*:n inconmensurable ; el ángel;*:n , indefinible .	kuimba'e;*:n niko tekovepaje ; kuña;*:n katu tupãremimbou , tekovepaje ijapyra'ỹ ; tupãremimbou mba'ekuaaporã'ỹ .
la inspiración;*:n del hombre;*:n es;ser:v la suprema gloria;*:n ; la inspiración;*:n de la mujer;*:n , la virtud;*:n extrema;extremo:a ; la gloria;*:n traduce;traducir:v grandeza;*:n , la virtud;*:n traduce;traducir:v divinidad;*:n .	kuimba'e;*:n py'ara'ã;*:n niko verapy;vera:n guasu;*:n ; kuña;*:n py'ara'ã;*:n katu , tekokatu paha;pa:n|*:n ; verapy;vera:n oñanduka py'aguasu , tekokatu oñanduka Tupã;tupã:n pytu;*:n .
el hombre;*:n tiene;tener:v la supremacía;*:n ; la mujer;*:n , la preferencia;*:n , la supremacía;*:n representa;representar:v la fuerza;*:n|forzar:v , la preferencia;*:n representa;representar:v el derecho;*:a|*:n .	kuimba'e;*:n niko oguereko;reko:v pokatu ; kuña;*:n katu oñembojeroviave;jerovia:v|mbojerovia:v , pokatu he'ise;'e:v|*:n pu'aka;*:n , ñembojeroviave;mbojerovia:n he'ise;'e:v|*:n teko'ajete .
el hombre;*:n es;ser:v fuerte;*:a|*:n por la razón;*:n , la mujer;*:n es;ser:v invencible por las lágrimas;lágrima:n , la razón;*:n convence;convencer:v , las lágrimas;lágrima:n conmueven .	kuimba'e;*:n niko imbarete;mbarete:n|mbarete:v iñakãngeta rupive;<hupi:n , kuña;*:n katu imbareteve;mbarete:n|mbarete:v hesay;<hesay:n rupi;*|<hupi:n , akãngeta ome'ẽ;me'ẽ:v jerovia;rovia:n|*:n , tesay;<hesay:n opoko;poko:v ñane;ñande:n korasõ;*:n sãre;sã:n .
el hombre;*:n es;ser:v capaz;*:a de todos;todo:a los heroísmos ; la mujer;*:n , de todos;todo:a los martirios , el heroísmo;*:n ennoblece , el martirio;*:n sublima .	kuimba'e;*:n niko ipy'aguasueterei ; kuña;*:n katu ohasakuaa;<hasa:v opaite;*|opa:n|pa:v jejahéire;jahéi:n , py'aguasu ñanemongakuaa;mongakuaa:v , jejahéi;jahéi:n ñanemoambuekatu;moambue:v .
el hombre;*:n es;ser:v el código;*:n , la mujer;*:n el evangelio;*:n , el código;*:n corrige;corregir:v , el evangelio;*:n perfecciona;perfeccionar:v .	kuimba'e;*:n niko tekovoña , kuña;*:n katu ñe'ẽngatu ; tekovoña omyatyrõ;myatyrõ:v , ñe'ẽngatu ohupytyka aguyje;*|*:n .
el hombre;*:n es;ser:v un;*:a templo;templar:v|*:n ; la mujer;*:n , un;*:a sagrario ; ante;*|*:n el templo;templar:v|*:n nos descubrimos;descubrir:v , ante;*|*:n el sagrario , nos arrodillamos;arrodillar:v .	kuimba'e;*:n niko opy ; kuña;*:n katu , tupãrenda ; opýpe jajechauka , Tupã;tupã:n renondépe;*|<henonde:n , ñañesũ;ñesũ:v .
el hombre;*:n piensa;pensar:v , la mujer;*:n sueña , pensar;*:v es;ser:v tener;*:v cerebro;*:n , soñar;*:v es;ser:v tener;*:v en la frente;*:n una;uno:n|un:a|unir:v aureola;*:n .	kuimba'e;*:n niko oñepy'amongeta , kuña;*:n katu ikerayvoty;kerayvoty:n , py'amongeta;*:n he'ise;'e:v|*:n jarekoha;reko:v akãrupa , kerayvoty;*:n he'ise;'e:v|*:n jarekoha;reko:v temirendy ñane;ñande:n akã;*:n jerére;jere:n .
el hombre;*:n es;ser:v un;*:a océano;*:n , la mujer;*:n , un;*:a lago;*:n ; el mar;*:n tiene;tener:v la perla;*:n que embelesa;embelesar:v , el lago;*:n tiene;tener:v la poesía;*:n que deslumbra;deslumbrar:v .	kuimba'e;*:n niko peteĩ;*:n para;*:n , kuña;*:n katu yrupa ; para;*:n oguereko;reko:v itaveratĩ ñanembojurujáiva;jurujái:v , yrupa oguereko;reko:v ñe'ẽpoty ñanemboresahóva;<hesaho:v .
el hombre;*:n es;ser:v un;*:a águila;*:n que vuela;volar:v , la mujer;*:n , el ruiseñor que canta;cantar:v , volar;*:v es;ser:v dominar;*:v el espacio;*:n|espaciar:v , cantar;*:v es;ser:v conquistar;*:v el alma;*:n .	kuimba'e;*:n niko peteĩ;*:n taguato;*:n ovevéva;veve:v , kuña;*:n katu masakaragua'i opurahéiva;purahéi:v , veve rupive;<hupi:n ñañemomba'e;momba'e:v arapýre;arapy:n , purahéi rupive;<hupi:n ñañemomba'e;momba'e:v angamimíre .
el hombre;*:n posee;poseer:v un;*:a faro;*:n , la conciencia;*:n ; la mujer;*:n tiene;tener:v la estrella;*:n|estrellar:v , la esperanza;*:n , el faro;*:n guía;*:n , la esperanza;*:n salva;*:n|salvar:v .	kuimba'e;*:n niko oguereko;reko:v tesapeha;<hesape:n , ha'éva;'e:v|ha'e:n tekopytee ; kuña;*:n katu oguereko;reko:v mbyja;*:n , ha'éva;'e:v|ha'e:n temira'ãrõ ; tesapeha;<hesape:n oporosãmbyhy , temira'ãrõ oporopysyrõ .
en fín , el hombre;*:n está;estar:v colocado;*:a|colocar:v donde termina;terminar:v la tierra;*:n , la mujer;*:n , donde comienza;comenzar:v el cielo;*:n .	ipahápe;*|pa:n|paha:n , kuimba'e;*:n niko oñembo'y;mbo'y:v|ñembo'y:v yvóra opahápe;opa:n|pa:v , kuña;*:n katu , yvága;*:n oñepyrũháme .
en medio;*:a|*:n|mediar:v de la calma;calmar:v|*:n de aquella noche;*:n de marzo;*:n , el Mariscal revistaba su ejército;*:n .	y;*:n sólo le respondió la noche con los vagos sollozos de la selva … Upe jasyapy;*:n pyhare;py:n|*:n py'aguapy;*:n aja;*|ja:v , Mburuvichapavẽ ojesareko;jesareko:v iguarinikuérare .
como;*|comer:v una;uno:n|un:a|unir:v vaga;vagar:v|vago:a pincelada blanca;blanco:a|*:n se perfilaban las líneas;línea:n de los cuerpos;cuerpo:n , prolongándose;prolongar:v (se) en la penumbra;*:n triste;*:a y suave;*:a , llena;lleno:a|llenar:v de rumores;rumor:n , en los cuales parecía;parecer:v desleírse;desleír:v (se) toda;todo:a la melancolía;*:n de las almas;alma:n y de las cosas;coser:v|cosa:n .	ku ta'ãnga hesakãporã'ỹvaicha;<hesakã:v (vaicha) ojehecha;<hecha:v hetemimi , ojehe'áva pytũmby;*:n|pytũ:n heko;<heko:n vy'a'ỹva;vy'a:n|vy'a'ỹ:n ha ikangývare;kangy:v , ka'aguy;ka'a:n|*:n ryapu;<hyapu:n pa'ũme;pa'ũ:n , omanombeguekatuhápe ohóvo;ha:v (vo) tekove;<heko:n|<hekove:n ha opa;*:n|pa:v mba'e;*:n .
–¡ Soldados del 14!	-¡ Guarini 14- ygua;y:n|*:n !
– dijo;decir:v el Mariscal – ¡ Cuatro pasos;paso:n al frente;*:n !	– he'i;'e:v Mburuvichapavẽ - ¡ Irundy guata;*:n tenonde;*|<henonde:n gotyo !
y avanzaron;avanzar:v quince;*:a|*:n hombres;hombre:n , semidesnudos , con el fusil;*:n terciado , la frente;*:n altiva;altivo:a .	ha itenonde papo kuimba'e;*:n , haime ijao'ỹva , imboka;mboka:n ijyva;yva:n|jyva:n ári , oñakãrupíva .
el guerrero;*:n los contempló;contemplar:v un;*:a momento;*:n , y luego ordenó;ordenar:v : –¡ Soldados del 43, a revistarse !	karai;*:n ñorairõhára;ñorairõ:n|*:n ojesareko;jesareko:v hesekuéra;ha'e:n sapy'ami;*|sapy'a:n , ha upéi ñe'ẽ;*:n pyrusúpe he'i;'e:v : -¡ Guarini 43- ygua;y:n|*:n , peñembosako'i;mbosako'i:v|ñembosako'i:v !
cuatro;*:a|*:n soldados;soldado:n|soldar:v se destacaron;destacar:v de la línea;*:n .	irundy;*:n guarini;*:n ojehechauka;<hecha:v|<hechauka:v ichupe;ha'e:n .
no quedaban;quedar:v más .	ndaiporivéima ambue;*:n .
los cuatrocientos;*:a que faltaban;faltar:v al regimiento;*:n dormían;dormir:v el buen;bueno:a sueño;*:n de la calma;calmar:v|*:n infinita;infinito:a en el fondo;*:n de los esteros , bajo;*|*:a|*:n|bajar:v las ruinas;ruina:n de los pueblos;pueblo:n , entre;*|entrar:v los fosos;foso:n de las trincheras;trinchera:n .	umi irundysa upe;*|*:n atyrusuguigua ndaiporivéima osapymijoáma;sapymi:v hikuái umi karugua;karu:n|*:n kirirĩ apyra'ỹva ruguáre;<hugua:n , táva;*:n ho'apáva;'a:v guy rupi;*|<hupi:n , yvykua guarini;*:n ojo'ova'ekue;jo'o:v pa'ũ;*:n rupi;*|<hupi:n .
aquellos cuatro;*:a|*:n hombres;hombre:n se perfilaban entre;*|entrar:v la noche;*:n , firmes;firmar:v|firme:n , solemnes , rígidos;rígido:a .	umi irundy;*:n kuimba'e;*:n iñapysẽ , pyhare;py:n|*:n aho'ípe , ñembo'yhápe;ñembo'y:n , tovasýpe;<hovasy:n , jepytasópe;jepytaso:n .
–¡ Soldados del 46! – continuó;continuar:v el Mariscal .	-¡ Guarani 46- ygua;y:n|*:n !- ombojoapy;mbojoapy:v Mburuvichapavẽ .
y avanzó;avanzar:v una;uno:n|un:a|unir:v sola;solo:a sombra;*:n .	ha peteĩ;*:n ta'ãnga iñipytũvante oñemotenonde;ñemotenonde:v .
algo de inmenso;*:a flotaba;flotar:v sobre;*|sobrar:v|*:n ella .	peteĩ;*:n mba'e;*:n kakuaa oñemyatymói;myatymói:v hi'ári;*|ha'e:n .
ese hombre;*:n llevaba;llevar:v la bandera;*:n .	upe;*|*:n kuimba'e;*:n oguereko;reko:v ñane;ñande:n retã;<hetã:n poyvi;*:n .
–¡ Soldados del 40, a la orden;*:n de revista;revestir:v|*:n !– mandó;mandar:v aquel amo;amar:v de pueblos;pueblo:n .	-¡ Guarini 40- ygua;y:n|*:n , peẽháma !- osapukái;sapukái:v upe;*|*:n karai;*:n ha'éva;'e:v|ha'e:n heta;<heta:v tava;va:v ruvicha;<huvicha:n .
ha;haber:v pyharéntema ombohovái chupe;chupar:v ka'aguy jahe'o asy reheve … Ante su deshilachada;deshilachar:v tienda;*:n|tender:v de campaña;*:n , el Mariscal contemplaba;contemplar:v los restos;resto:n de su ejército;*:n .	pe;*|*:n hogasapy'agua ikuapáva renonde;<henonde:n guive , Mburuvichapavẽ ojesareko;jesareko:v iguarini;guarini:n atyrusupavẽ rembyremíre .
sus ayudantes;ayudante:n , silenciosos;silencioso:a , le rodeaban;rodear:v , sin atreverse a aproximársele;aproximar:v (se+le) .	ipytyvõhára;pytyvõ:n|pytyvõhára:n , kirirĩháme , oñemo'aĝui , oja'ỹre;ja:v hese;ha'e:n .
a la distancia;*:n , allá en el seno;*:n de las frondas vecinas;vecino:a , un;*:a pájaro;*:n nocturno;*:n desgranaba;desgranar:v dulcemente su rosario;*:n de arpegios .	mombyry'imi guive , yvyrakuéra;yvyra:n pa'ũme;pa'ũ:n , namombyrýiva upégui;upe:n , peteĩ;*:n guyra;*:n pyharegua;py:n|pyhare:n ohenduka ipurahéi ryapu;<hyapu:n he'ẽ;<he'ẽ:v asýva .
aquel hombre;*:n se contemplaba;contemplar:v en ese instante;*:n , de pie;piar:v|*:n ante;*|*:n la Historia , en la noche;*:n precursora de lo inevitable , entre;*|entrar:v el claroscuro que anunciaba;anunciar:v el alba;*:n , el día;*:n próximo;*:a que iba;ir:v a traer;*:v , con su luz;*:n , con la sonrisa;*:n de los cielos;cielo:n y las alegrías;alegría:n intensas;intenso:a de la vida;*:n , la caricia desoladora de la muerte;*:n , la desesperación;*:n de la última;último:a derrota;*:n|derrotar:v , el vértigo;*:n sin límites;límite:n de la postrer caída;caído:a|*:n|caer:v .	upe;*|*:n kuimba'e;*:n oma'ẽ;ma'ẽ:v ijehe;he:n upe;*|*:n jave;*|ja:n , ñembo'yhápe;ñembo'y:n , Tembiasakue renondépe;*|<henonde:n , upe;*|*:n pyharépe;py:n|pyhare:n , oguerúva;ru:v hendive;ha'e:n mba'e;*:n ojejokokuaa'ỹva;joko:v|jejoko:v , tesakã para;*:n para;*:n aja;*|ja:v omombe'úva;mombe'u:v ko'ẽti oñembojaha;mboja:v|ja:v|ñemboja:v mbeguekatúpe , ohenonde'ávo;<henonde'a:v (vo) ára;*:n pyahu oguerúva;ru:v , hesakã;<hesakã:v rupive;<hupi:n , yvága;*:n pukavýpe;pukavy:n ha pytuhẽ;*:n vy'a;*:n reheve ; mano;*:n ravi'u rasyete;<hasy:n , py'aropu ñehundi;hundi:n paha;pa:n|*:n rehegua ha akãnga'u;akã:n|*:n ijapyra'ỹva je'a;'a:n ivaivéva;vai:v oiko;ko:v|iko:v jave;*|ja:n .
incendiaban;incendiar:v el alma;*:n del guerrero;*:n todas;todo:a sus bravuras , sus odios;odio:n , sus desesperanzas .	mburuvichapavẽ ángape;ánga:n ohapy;<hapy:v umi ipy'aguasukue , hemiroyrõ ha hemira'ãrõ'ỹ .
por su cerebro;*:n pasaba;pasar:v la visión;*:n de los esfuerzos;esfuerzo:n que efectuara;efectuar:v , de aquel avance;*:n|avanzar:v fracasado;fracasar:v , de aquella resistencia;*:n desesperada;desesperado:a|desesperar:v a través;*:n de las llanuras;llanura:n , las montañas;montaña:n y las selvas;selva:n .	iñakã;akã:n rupi;*|<hupi:n ohasa;<hasa:v opaite;*|opa:n|pa:v ñeha'ã;ha'ã:n|*:n ojapova'ekue;<japo:v , upe;*|*:n ñemotenonde hekomarãva'ekue , upe;*|*:n jepytaso;*:n guasuete ojapova'ekue;<japo:v ñu;*:n , yvyty;*:n ha ka'aguýre;ka'aguy:n .
no le quedaban;quedar:v en aquella hora;*:n ni hombres;hombre:n , ni fusiles;fusilar:v|fusil:n , ni cañones;cañón:n .	upe;*|*:n aravópe;aravo:n nahembyvéima;<hemby:v chupe;ha'e:n guarini;*:n , mboka;*:n ha mbokapuharusu .
sus esqueletos;esqueleto:n de regimientos;regimiento:n estaban;estar:v sin caballos;caballo:n , sin carabinas , y sus soldados;soldado:n|soldar:v dormitaban;dormitar:v al pie;piar:v|*:n de las lanzas;lanza:n clavadas;clavar:v en el suelo;*:n|soler:v , muchas;mucho:a de las cuales no tenían;tener:v hierros ni banderolas;banderola:n , porque aquellos quedaron;quedar:v clavados;clavar:v en el pecho;*:n del contrario;*:n y éstas se desflecaron con los vientos;viento:n de cinco;*:a|*:n años;año:n y las pudrieron;pudrir:v las lluvias;lluvia:n .	umi ijatyrusu niko kanguekuereíntema ha ndaikavajúi , naimbokapukúi ha umi iguarinikuéra okeparei;ke:v oñembo'yhápe;mbo'y:v|ñembo'y:v umi yvyrakua;*:n ykére;*|yke:n ojekutúva;kutu:v yvýre;yvy:n , heta;<heta:v umíva apytépe;*|apyte:n ndoguerekovéimava;reko:v kuarepotĩhũ ijapýrare;apýra:n ha ndoguerekovéimava;reko:v ñane;ñande:n retã;<hetã:n poyvi;*:n , umíva opytágui;pyta:v umi tajasu;*:n ñande'aho'íva pyti'áre;pyti'a:n ha yvytu;*:n po;*|*:n arygua;ary:n ombochalaipáva ha ama;*:n ombotujupáva .
de sus conciudadanos;conciudadano:n no quedaba;quedar:v sino;*:n un;*:a montón;*:n informe;informar:v|*:n , un;*:a harapo;*:n de pueblo;poblar:v|*:n , durmiendo;dormir:v el sueño;*:n de su desgracia;desgraciar:v|*:n , allí , entre;*|entrar:v los destruidos;destruir:v convoyes;convoy:n , bajo;*|*:a|*:n|bajar:v el frío;freír:v|*:a|*:n relente del rocío;rociar:v|*:n .	hetãyguágui;<hetãygua:n hembýva;<hemby:v niko peteĩ;*:n aty;*:n hete;<hete:n jekuaa'ỹva;kuaa:n , peteĩ;*:n táva;*:n imeĝuambaitéva , okéva;ke:v teko'asy pohéipe , upépe;upe:n , mba'yrumýi;*:n oñembyaipáva pa'ũme;pa'ũ:n , ysapy;*:n ro'ysã asyete guýpe .
y sobre;*|sobrar:v|*:n los cuerpos;cuerpo:n tendidos;tender:v|tendido:n en la hierba;*:n fina;fino:a y suave;*:a , sentíase pasar;*:v el tenue;*:a viento;*:n nocturnal como;*|comer:v una;uno:n|un:a|unir:v leve;*:a caricia .	ha tetekuéra;<hete:n opytu'úva;pytu'u:v ñana;*:n karape ha hu'ũva;<hu'ũ:v ári oñeñandu;ñeñandu:v|<ñandu:v ohasárõ;<hasa:v (rõ) yvytu;*:n peju;ju:v , pyharegua;py:n|pyhare:n , vaicha oporohavi'úva;havi'u:v ohasávo;<hasa:v (vo) .
– Tuyutí , Estero Bellaco , Curupayty …– exclamaba el guerrero;*:n .	– Tujutĩ , Estero Bellaco , Kurupa'yty …- imandu'a;mandu'a:n|mandu'a:v karai;*:n ñorairõhára;ñorairõ:n|*:n .
era;*:n|ser:v la visión;*:n del pasado;pasar:v|*:a|*:n , del ayer;*:n inmediato , de la defensa;*:n toda;todo:a aún subsistente , sin que hubieran;haber:v bastado para anular;*:n|*:v la soberbia;soberbio:a|*:n expresión;*:n de su fiereza , ni los contrastes;contrastar:v|contraste:n continuos;continuo:n , ni las fatalidades;fatalidad:n todas;todo:a , cayendo sobre;*|sobrar:v|*:n sus hombros;hombro:n con el desplome;desplomar:v|*:n colosal;*:a de una;uno:n|un:a|unir:v montaña;*:n .	upéicha;upe:n ohecha;<hecha:v ha'e;*|'e:v|*:n umi mba'e;*:n ohasava'ekue;<hasa:v , kuehe ha kuehevégui hi'aĝuivéva , pysyrõ pytu;*:n ogue'ỹvaguigua , ndaikatúi;katu:v ombogue;gue:v hovágui;<hova:n pe;*|*:n heko;<heko:n pochy;*:n guasuete , pe;*|*:n jehasa porã;po:n ha jehasa vai ojopyruva'ekue;jopyru:v ha upéicha;upe:n avei opaite;*|opa:n|pa:v po'a'ỹ;po'a:n|'a:v , ho'áva;'a:v hikuái ijati'y;ati'y:n ári ku yvytyrusu pohyikue ojeityramoguáicha hi'ári;*|ha'e:n .
¡ Y aquel señor;*:n de naciones;nación:n , a quien concluían de hostigar;*:v sus mismos;mismo:a hermanos;hermano:n en la raza;*:n , dentro del cerco;*:n|cercar:v de hierro;*:n en que le envolvían;envolver:v ; aquel amo;amar:v de pueblos;pueblo:n , ante;*|*:n cuyo camino;*:n|caminar:v se prosternaban las multitudes;multitud:n , como;*|comer:v ante;*|*:n el paso;pasar:v|*:n de un;*:a dios;*:n ; aquel guerrero;*:n cuya espada;*:n se aprestaba;aprestar:v a describir;*:v bajo;*|*:a|*:n|bajar:v los cielos;cielo:n la elíptica sangrienta;sangriento:a , entre;*|entrar:v cuyos términos;término:n iba;ir:v a rimarse;rimar:v (se) el último;*:a|*:n canto;*:n|cantar:v de la epopeya;*:n , se sintió;sentir:v inmenso;*:a porque se sintió;sentir:v la Patria !	ha pe;*|*:n tetãita ruvicha;<huvicha:n , ipehẽnguevoi;pehẽngue:n ojaheipaháva hese;ha'e:n , omongora jetu'úva hikuái chupe;ha'e:n ; pe;*|*:n tavaita rendota;<hendota:n hapépe;<hape:n oguerekóva;reko:v hetaiterei;<heta:v hetãygua;<hetãygua:n|<hetã:n oñesũva;ñesũ:v henondépe;*|<henonde:n ohayhúgui;<hayhu:v chupe;ha'e:n , ku Tupã;tupã:n ohasaramoguáicha henonde;<henonde:n rupi;*|<hupi:n ; pe;*|*:n ñorãirohára ikysepukúpe , tuguýpe;<huguy:n , yvagapýpe;yvága:n ohaítava peteĩ;*:n mba'e;*:n rechapyrã;<hechapyrã:n|<hecha:n ; oñemboguapýtava ipy'aguasúva;py'aguasu:v purahéipe , iñe'ẽpujojáva ; añetehápe;*|añete:n , upe;*|*:n jave;*|ja:n , ha'e;*|'e:v|*:n oñeñandu;ñeñandu:v|<ñandu:v tuvichárõ;<huvicha:n|<huvicha+rõ:s oñandúgui;<ñandu:v ipype;ha'e:n oñemopeteĩha;mopeteĩ:v hetã;<hetã:n .
y la visión;*:n del éxodo;*:n de su pueblo;poblar:v|*:n también cruzó;cruzar:v por su mente;*:n .	ha hetãygua;<hetãygua:n|<hetã:n guata;*:n pukuete;pu:n ohasa;<hasa:v avei iñakãre;akã:n .
por caminos;camino:n tristes;triste:a y polvorientos veía;ver:v marchar;*:v , como;*|comer:v en los pasados;pasado:n|pasado:a|pasar:v días;día:n , aquella larga;largo:a|*:n|largar:v columna;*:n de desolación;*:n y de miseria;*:n , moviéndose;mover:v (se) lentamente bajo;*|*:a|*:n|bajar:v la caricia de fuego;*:n de los soles estivales , marchando;marchar:v en pos de la desesperación;*:n , de la derrota;*:n|derrotar:v y de la muerte;*:n .	tape;<hape:n henyhẽva;<henyhẽ:v vy'a'ỹ;vy'a:n|*:n ha yvytĩmbógui , oguatahague;guata:v rupi;*|<hupi:n , ára;*:n upe;*|*:n mboyveguápe , pe;*|*:n tysýi pukuete;pu:n hova;<hova:n pore'ỹva;po:n|pore:n ha ijehasa'asyetéva , oku'éva;ku'e:v mbegue kane'õ;*:n kuarahy;*:n aku pytu;*:n guýpe , guata;*:n ohóva;ha:v py'aropu , po'a'ỹ;po'a:n|'a:v ha mano;*:n rapére;<hape:n .
era;*:n|ser:v un;*:a largo;*:a|*:n|largar:v y doliente desfile;desfilar:v|*:n de siluetas blancas;blanco:a|blanca:n ; blancuras de guiñapos sobre;*|sobrar:v|*:n palideces de carnes;carne:n corroídas por el hambre;*:n ; blancuras de muerte;*:n sobre;*|sobrar:v|*:n rostros;rostro:n en los cuales agonizaban las más dulces;dulce:a|dulce:n y rojas;rojo:a rosas;rosa:n de la juventud;*:n ; albas livideces impresas en frentes;frente:n impúberes por los más hondos;hondo:a sufrimientos;sufrimiento:n ; blancuras de niños;niño:n muertos;muerto:a|morir:v|muerto:n sobre;*|sobrar:v|*:n el pecho;*:n exhausto y flácido , que se negaba;negar:v a derramar;*:v una;uno:n|un:a|unir:v gota;*:n de la generosa;generoso:a leche;*:n de la madre;*:n ; nieves;nieve:n|nevar:v tempranas sobre;*|sobrar:v|*:n cabezas;cabeza:n que ayer;*:n mismo;*:a ostentaban;ostentar:v esa aureola;*:n primaveral formada;formar:v sobre;*|sobrar:v|*:n las sienes por la comba;combar:v del rizo;rizar:v|*:n negro;*:a|*:n o la voluta del bucle;*:n rubio;*:a|*:n .	peva;va:v niko va'ekue peteĩ;*:n guata;*:n puku ha hekorasýva hetavehápe;<heta:v tekove;<heko:n|<hekove:n ra'ãnga morotĩmimi , ku morotĩ ao;*:n sorokuemiguigua ombo'aóva to'o;so'o:n ijaku'ipáva vare'águi , ku morotí manoguigua ojehecháva;<hecha:v maymáva rováre;va:v|<hova:n ojukambeguekatúva mitãrusu;*:n reko;<heko:n re'ẽ asýva ha orekóva;ko:v yvoty;*:n pytã pyahu pytu;*:n ; mitãrusu;*:n rova;va:v|<hova:n morotĩ ha'éva;'e:v|ha'e:n jehasa asy rapykuere;<hapykue:n ; ku morotĩ mitãmimi omanova'ekue;mano:v itúva;ru:n jyva;*:n ári sa'y;*:n , hete;<hete:n kane'õ;*:n kangýva , noñohẽséiva - michĩmínte jepe;*|pe:n - isy;sy:n marangatu kambykuemi ; oñemoakã'apatĩva ha ndahi'aréi peve;*|pe:n oguerekóva;reko:v akãremirendy opiro'ýva ojehe'áva akãrague hũ ijapesỹiva rehe térã akãrague sa'yju iñapopẽ'asýva rehe .
hombres;hombre:n veía;ver:v , tambaleantes sobre;*|sobrar:v|*:n el camino;*:n|caminar:v , como;*|comer:v borrachos;borracho:n|borracho:a por el hambre;*:n .	ohecha;<hecha:v kuimba'eita , ho'a;'a:v ha opu'ãva;pu'ã:v upe;*|*:n tapére;<hape:n , vaicha ku oka'úva hikuái vare'águi .
tenían;tener:v grandes;grande:a ojos;ojo:n dilatados;dilatar:v mirando;mirar:v hacia los cielos;cielo:n , ojos;ojo:n sonámbulos;sonámbulo:a|sonámbulo:n , percibidores al acaso de quién sabe;saber:v qué visiones;visión:n de paz;*:n , de hondo;*:a|*:n descanso;descansar:v|*:n más allá del horizonte;*:n y aún más allá de la existencia;*:n misma;mismo:a .	hesapo guasu;*:n hikuái ha ojesareko;jesareko:v yvágare;yvága:n , hesakuéra;<hesa:n ojogua;jogua:v umi ikeraguatáva resápe;<hesa:n , ohechamombyrýva oimépoku mba'eichagua;mba'e:n py'aguapýpa;py'aguapy:n|py'aguapy+pa:s , oñandúva;<ñandu:v pytu'u;*:n ipypukúva ha ojepysóva;pyso:v ñande;*|*:n resa;<hesa:n ohechaha;<hecha:v peve;*|pe:n ha amo gotyove ha ohecháva;<hecha:v tekove;<heko:n|<hekove:n apyra'ỹgui amo gotyove .
miraba;mirar:v caer;*:v ancianas;anciano:a|anciana:n con la frente;*:n sobre;*|sobrar:v|*:n el polvo;*:n , entregándose;entregar:v (se) a la eternidad;*:n sin un;*:a solo;*|*:a|*:n gesto;*:n , sin un;*:a solo;*|*:a|*:n estremecimiento ; mientras que pequeños;pequeño:a agonizantes llenaban;llenar:v los aires;airar:v|aire:n con sus vagidos desesperados;desesperado:a|desesperar:v , última;último:a protesta;protestar:v|*:n de la vida;*:n contra;*:n la infecundidad del destino;destinar:v|*:n y la esterilidad;*:n nauseabunda de la tumba;*:n|tumbar:v .	ohecha;<hecha:v mba'éichapa;*|mba'e:n ĝuaiĝuimimi ho'a;'a:v ha ombota;mbota:v isyva;syva:n yvytĩmbóre , oñeme'ẽvo;me'ẽ:v (vo) tekotapiaitépe he'i'ỹre mba'eve;mba'e:n , osysyi'ỹre ; mitãmimi omyenyhẽ;myenyhẽ:v aja;*|ja:v upe;*|*:n tenda;<henda:n tasẽsorógui , ha'éva;'e:v|ha'e:n ñembyasy paha;pa:n|*:n peichagua;pe:n teko;<heko:n ñemoña'ỹvére;ñemoña:n|moña:n ha tyvyty;*:n tujukue;tuju:n ryakuã potĩpyrére .
entre;*|entrar:v compactos;compacto:n grupos;grupo:n de mujeres;mujer:n , veía;ver:v llegar;*:v a los heridos;herido:n|herir:v , a los moribundos;moribundo:a , a aquellos a quienes la suprema insondable roía;roer:v con su único;*:a e implacable diente;*:n .	kuñaita oguatáva;guata:v ojo'aripa apytépe;*|apyte:n ohecha;<hecha:v oĝuahẽ;guahẽ:v jave;*|ja:n umi ojejapiva'ekue;<japi:v , umi omanombotáva ha umi tapicha;<hapicha:n chupekuéra;ha'e:n oikarãiva apyra'ỹ jarýi;*:n hãi;<hãi:n peteĩme;peteĩ:n ha hapykuere;<hapykue:n rasyetévape .
algunos;alguno:a , tirados;tirado:a|tirar:v sobre;*|sobrar:v|*:n carros;carro:n desvencijados , clamoreaban sin término;*:n y sin consuelo;*:n|consolar:v ; otros;otro:n|otro:a , con sus carnes;carne:n carcomidas;carcomer:v por el abandono;abandonar:v|*:n , exhibían;exhibir:v al aire;airar:v|*:n libre;*:a|*:n|librar:v las más asquerosas muecas de la infelicidad humana;humano:a ; varios;vario:a , agitaban;agitar:v lentamente sus manos;mano:n , cual si persiguieran;perseguir:v la forma;formar:v|*:n de una;uno:n|un:a|unir:v visión;*:n desvanecida;desvanecer:v entre;*|entrar:v sus dedos;dedo:n .	oĩ;ĩ:v , karréta kelembumi guive , ohendukáva ipy'arasy;py'arasy:n tyre'ỹmi ; ambue;*:n katu , ohechaukáva;<hecha:v|<hechauka:v hete;<hete:n rembyremi ha'éva;'e:v|ha'e:n avei pore'ỹ;po:n|pore:n rembi'u;<hembi'u:n ha oñondivepa ohechauka;<hecha:v|<hechauka:v hikuái , ko yvága;*:n guýpe , vy'a'ỹ;vy'a:n|*:n paha;pa:n|*:n ha'ãnga tyaíva ; heta;<heta:v oĩ;ĩ:v ijapytepekuéra mbeguekatumi ohupíva;<hupi:v ipo;po:n ñaimo'ã;imo'ã:v|*:n ku ojapyhyséva ikuãmimíme upe;*|*:n kepegua porãite;po:n oguéva;gue:v ohóvo;ha:v (vo) hesa;<hesa:n renondégui;<henonde:n .
y aquello era;*:n|ser:v el crimen;*:n de que se le acusaba;acusar:v , el gran;grande:a delito;*:n de caer;*:v con todo;*:a su pueblo;poblar:v|*:n , de sumirlo;sumir:v (lo) en su fosa;*:n , de arrastrarlo;arrastrar:v (lo) en su caída;caído:a|*:n|caer:v de coloso herido;*:n|herir:v y hostigado;hostigar:v a la profundidad;*:n del abismo;*:n en que él mismo;*:a se tumbaba;tumbar:v , en el vértigo;*:n de esa parábola;*:n inmensa;inmenso:a , cuyo término;*:n fatal;*:a tenía;tener:v que ser;*:n|*:v la trágica hediondez de un;*:a sudario .	ha upéva;*|upe:n niko kuri;*|*:n pe;*|*:n mba'e;*:n vaiete ijati'y;ati'y:n ári omboguapýva;guapy:v umi ohayhu'ỹva;<hayhu:v chupe;ha'e:n , ñemotĩ guasu;*:n ha'e;*|'e:v|*:n ohasáva;<hasa:v ho'ahaguére;'a:v hetãygua;<hetãygua:n|<hetã:n ndive , ho'águi;'a:v yvykua pypukúvape , ombotyryhaguére umi hapichápe;<hapicha:n hendive;ha'e:n ha ha'e;*|'e:v|*:n , ku tuichaitéva , ho'áre;'a:v ha ha'evoi;ha'e:n ojeitýre;ity:v , hete;<hete:n meĝuáre , yvykua ndepypukuetévape , ojepoihápe;poi:v ñe'ẽngue;ñe'ẽ:n ñemi akãnga'úpe;akãnga'u:n , yvykua opáva;opa:n|pa:v manóme;mano:n ha orekóva;ko:v omanóva;mano:v ao;*:n ryakuãngue pyti'u;*:n .
entonces , en esos ojos;ojo:n que no habían;haber:v llorado;llorar:v jamás;jamar:v , profundos;profundo:a ojos;ojo:n pardos;pardo:a que contemplaron;contemplar:v impasibles el ataque;atacar:v|*:n , el incendio;incendiar:v|*:n y la derrota;*:n|derrotar:v , brilló;brillar:v una;uno:n|un:a|unir:v lágrima;*:n , como;*|comer:v un;*:a último;*:a|*:n esplendor;*:n de sol;*:n languideciente sobre;*|sobrar:v|*:n el fondo;*:n cobrizo de un;*:a ocaso;*:n .	upérõ;upe:n|upe+rõ:s , umi hesa;<hesa:n araka'eve ndahesayiva'ekue , tesa;<hesa:n sa'y;*:n apatĩva ohechava'ekue;<hecha:v , kirirĩme , ñanderehegua'ỹ ojeitýrõ;ity:v (rõ) py'arõpe iguarinikuéra ári , oñemyendýrõ;myendy:v (rõ) tata;<hata:n ñane;ñande:n retãyguáre;<hetãygua:n ha itenondérõguare ñanderehe;ñande:n ; umi heságui;<hesa:n opu;pu:v tesay;<hesay:n , ku kuarahy;*:n kangy hesakãguasu;<hesakã:v paharamoguáicha amo kuarahy;*:n reikévo;ke+vo:v , ka'arupytũ aho'ípe .
y la larga;largo:a|*:n|largar:v columna;*:n de desesperación;*:n y de miserias;miseria:n seguía;seguir:v marchando;marchar:v lentamente , sobre;*|sobrar:v|*:n el camino;*:n|caminar:v calcinado por el sol;*:n , envuelta;envuelto:a|envolver:v en sus blancos;blanco:a|blanco:n guiñapos , entre;*|entrar:v los bosques;bosque:n floridos;florido:a , bajo;*|*:a|*:n|bajar:v la serenidad;*:n impasible del espacio;*:n|espaciar:v .	ha pe;*|*:n tysýi pukuete;pu:n henyhẽva;<henyhẽ:v mba'embyasy ha teko'asýgui oguatánte;guata+nte:v|guata:v ohóvo;ha:v (vo) mbeguekatumi , tape;<hape:n kuarahy;*:n ojopéva;jope:v rupi;*|<hupi:n , oñemamáva ao;*:n sorokuemi isa'y;sa'y:n morotĩvape , ka'aguay ipotypáva rupi;*|<hupi:n , ára;*:n rovasyete;<hovasy:n guy rupi;*|<hupi:n .
llegaba;llegar:v el día;*:n .	iñapysẽ mbeguekatu ko'ẽ;*:n .
y ante;*|*:n el ejército;*:n que se aprestaba;aprestar:v a la pelea;pelear:v|*:n , el Mariscal saludó;saludar:v por última;último:a vez;*:n el estandarte;*:n , entre;*|entrar:v tanto;*:n que el Aquidabán mugía;mugir:v a la distancia;*:n entre;*|entrar:v sus rocas;roca:n centenarias , como;*|comer:v si llevara;llevar:v a los mares;mar:n lejanos;lejano:a y rumorosos el alarido de protesta;protestar:v|*:n con que se desplomaban;desplomar:v un;*:a ideal;*:n , una;uno:n|un:a|unir:v patria;*:n y una;uno:n|un:a|unir:v raza;*:n .	ha iguarinikuéra renondépe;*|<henonde:n , oñembosako'ímava;mbosako'i:v|ñembosako'i:v oñorairõhaguáicha , Mburuvichapavẽ oñakãity;ñakãity:v paha;pa:n|*:n ñane;ñande:n retã;<hetã:n poyvípe;poyvi:n , upe;*|*:n aja;*|ja:v Aguidabán , namombyrýiva upégui;upe:n , otororõ;tororõ:v ohasávo;<hasa:v (vo) itaita;taita:n apyte;*:n rupi;*|<hupi:n , ku ogueraharamoguáicha para;*:n mombyryguápe ha hi'yrasẽvape , umi ñe'ẽrasyete omombe'úva;mombe'u:v oĝuahẽhague;guahẽ:v ipahápe;*|pa:n|paha:n peteĩ;*:n temiandu;<hemiandu:n , peteĩ;*:n tetã;<hetã:n ha peteĩ;*:n teko;<heko:n .
martin Luther King Junior , el más grande;*:a luchador;*:n de los Estados Unidos por la igualdad;*:n de los negros;negro:a|negro:n .	martin Luther King Junior niko ñorairõhára;ñorairõ:n|*:n tuichavéva Estados Unidos retãme;<hetã:n oñeha'ãva'ekue;ha'ã:v|ñeha'ã:v ombojoja;joja:v|mbojoja:v ipirehũva ha ipiremorotĩvape .
luchó;luchar:v siempre usando;usar:v métodos;método:n no violentos;violento:a .	akóinte iñorairõme;ñorairõ:n oipurúkuri py'aguapy;*:n reko;<heko:n .
nació;nacer:v en Atlanta , Estados Unidos , el día;*:n 15 de enero;*:n del año;*:n 1929.	heñoi'akue Atlanta , Estados Unidos retãme;<hetã:n , ára;*:n 15 jasyteĩ;*:n ary;*:n 1929- pe;*|*:n .
su padre;*:n fue;ir:v|ser:v el pastor;*:n bautista Martin Luther King y su madre;*:n Alberta Williams King .	itúva;ru:n , pa'I bautista , herava'ekue;<héra:v Martin Luther King ha isýkatu;sy:n Alberta Williams King .
su nombre;*:n|nombrar:v original;*:n - al igual;*:n que su padre;*:n - fue;ir:v|ser:v Michael pero;*|*:n su padre;*:n lo cambió;cambiar:v por Martin Luther en homenaje;*:n a Martín Lutero .	héra;<héra:n|<héra:v ypykue;ypy:n|y:n - itúvaicha;ru:n - Michael , itúva;ru:n omyengoviava'ekue Martin Luther rehe ohechakuaávo;<hecha:v (vo) Martín Lutero - pe;*|*:n .
esto ocurrió;ocurrir:v durante un;*:a viaje;viajar:v|*:n a Alemania hacia el año;*:n 1934.	ko mba'e;*:n ojehúkuri;jehu+kuri:v|jehu:v ohorõguare hikuái Alemania retãme;<hetã:n ary;*:n 1934 rupi;*|<hupi:n .
martin tuvo;tener:v una;uno:n|un:a|unir:v hermana;*:n llamada;llamar:v|*:n|llamado:a Christine y un;*:a hermano;*:n menor;*:a|*:n llamado;llamar:v|*:a Alfred .	martin reindy;<heindy:n héra;<héra:n|<héra:v Christine ha ityvýra;ryvy:n katu Alfred .
martin Luther se casó;casar:v en el año;*:n 1953 con Coretta Scott con quien tuvo;tener:v cuatro;*:a|*:n hijos;hijo:n ( Yolanda , Martin , Dexter y Bernice ).	martin Luther ombojoaju;mbojoaju:v hekove;<heko:n|<hekove:n Coretta Scott rehe , ha'ekuéra;*|ha'e:n omendákuri;menda:v|menda+kuri:v ary;*:n 1953- pe;*|*:n ha oguerekókuri;reko+kuri:v|reko:v irundy;*:n ñemoñare;ñemoña:n|moña:n|*:n ( Yolanda , Martin , Dexter ha Bernice ).
desde niño;*:n Martin Luther King sintió;sentir:v la discriminación;*:n por ser;*:n|*:v negro;*:a|*:n .	imitã;mitã:n|mitã:v guive Martin Luther King oñandúmakuri;<ñandu:v|<ñandu+kuri:v pe;*|*:n ñemboyke;mboyke:n ipirehũhaguére .
se cuenta;contar:v|*:n que tenía;tener:v 6 años;año:n cuando dos;*:a|*:n amigos;amigo:n blancos;blanco:a|blanco:n le dijeron;decir:v que no podían;poder:v jugar;*:v con él porque era;*:n|ser:v negro;*:a|*:n .	orekórõguare;ko:v (ramo+guare) 6 ay;*:n mokõi;*:n iñangirũ;angirũ:n he'íkuri;'e+kuri:v|'e:v chupe;ha'e:n ndaikatuiha;katu:v oñembosarái;mbosarái:v hendive;ha'e:n ipirehũhaguére .
inició;iniciar:v sus estudios;estudio:n en Atlanta y a los 15 años;año:n ingresó;ingresar:v al Morehouse College que era;*:n|ser:v una;uno:n|un:a|unir:v universidad;*:n para los jóvenes;joven:n|joven:a de color;*:n , donde en el año;*:n 1948 se graduó;graduar:v en Sociología ; pasando;pasar:v al Crozer Theological Seminary en Chester , Pensilvania donde se hizo;hacer:v Licenciado en Teología , en el año;*:n 1951.	oñemoarandu'ypýkuri Atlanta - pe;*|*:n ha 15 ary;*:n ombotývo;mboty:v (vo) oikékuri;ke+kuri:v|ke:v Morehouse College - pe;*|*:n ha'éva;'e:v|ha'e:n mbo'ehaovusu mitãrusu;*:n ipirehũvape ĝuarã , upépe;upe:n ary;*:n 1948- pe;*|*:n omohu'ã iñemoarandu Avano'õkuaatýpe ; upégui;upe:n ohasa;<hasa:v CrozerTheological Seminary oĩva;ĩ:v Chester , Pensilvania - pe;*|*:n oikohaguépe;ko:v|iko:v chugui;ha'e:n Tupãkuaatyhára , ary;*:n 1951- pe;*|*:n .
a continuación;*:n estudió;estudiar:v en la Universidad de Boston donde , en el año;*:n 1955, se hizo;hacer:v Doctor en Filosofía .	upe;*|*:n rire oho;ha:v oñemoarandu Boston Mbo'ehaovusúpe oikohaguépe;ko:v|iko:v chugui;ha'e:n , ary;*:n 1955- pe;*|*:n , Tembikuaajára Arandupykuaatýpe .
a lo largo;*:a|*:n|largar:v de su juventud;*:n y por toda;todo:a su vida;*:n lideró;liderar:v un;*:a gran;grande:a movimiento;*:n que por medios;medio:n|medio:a pacíficos;pacífico:a reclamó;reclamar:v el trato;*:n|tratar:v igualitario para los negros;negro:a|negro:n .	imitãrusúpe;mitãrusu:n ha hekove;<heko:n|<hekove:n pukukue javeve;veve:v omotenondékuri peteĩ;*:n ñemongu'e py'aguapy;*:n rekópe;<heko:n ohekava'ekue;<heka:v tekojoja;<hekojoja:n mayma ipirehũvape ĝuarã .
entre;*|entrar:v sus acciones;acción:n|accionar:v más recordadas;recordar:v , se mencionan;mencionar:v : el boicot;*:n de ómnibus;*:n de Montgomery , en el año;*:n 1955; y la marcha;marchar:v|*:n por el trabajo;trabajar:v|*:n y la libertad;*:n realizada;realizar:v|realizado:a en Washington , en el año;*:n 1963; donde pronunció;pronunciar:v su famoso;*:a|*:n discurso;*:n “ Tengo un;*:a sueño;*:n ”.	hembiapokue;<hembiapo:n ojehecharamovéva;<hecha:v apytépe;*|apyte:n , oĩ;ĩ:v : mba'yruguata ñemombyta Montgomery - pe;*|*:n , ary;*:n 1955- pe;*|*:n ; ha guatapuku mba'apo;*:n ha tekosãsoguigua ojejapova'ekue;<japo:v Washington - pe;*|*:n , ary;*:n 1963- pe;*|*:n ; ohendukahaguépe iñe'ẽsyry herakuãvéva “ Areko peteĩ;*:n kerayvoty;*:n ”.
la mayor;*:a|*:n parte;partir:v|*:n de sus reclamos;reclamo:n fueron;ir:v|ser:v escuchados;escuchar:v y aprobados;aprobar:v|aprobado:a en la “ Ley de los derechos;derecho:n|derecho:a civiles;civil:n ” y en la “ Ley del derecho;*:a|*:n a voto;votar:v|*:n ”.	heta;<heta:v umi imba'ejerure oñehendu;<hendu:v ha oñemboajékuri;mboaje:v|mboaje+kuri:v “ Ava rekopy;<heko:n|reko:n léipe ” ha “ Jeporavoguigua léipe ”.
por su incansable;*:a labor;*:n a favor;*:n de los negros;negro:a|negro:n , por el no a la guerra;*:n y por la reivindicación de los pobres;pobre:a|pobre:n , Martín Luther King recibió;recibir:v en el año;*:n 1964 el Premio Nobel de la Paz .	hembiapo;<hembiapo:n kane'õ'ỹre;kane'õ:n ipirehũva rayhupápe , avei ombotovére ñorairõ;*:n ha ojepy'apýre;jepy'apy:v mboriahukuérare , Martin Luther King ohupytýkuri;<hupyty:v|<hupyty+kuri:v , ary;*:n 1964- pe;*|*:n , Nobel Jopói Py'aguapyguigua .
en el año;*:n 1977, el Presidente Jimmy Carter le otorgó;otorgar:v de manera;*:n póstuma;póstumo:a la Medalla Presidencial de la Libertad ; y en el año;*:n 2004, se le otorgó;otorgar:v la Medalla de Oro del Congreso de los Estados Unidos .	ary;*:n 1977- pe;*|*:n , Tetãruvicha Jimmy Carter ome'ẽkuri;me'ẽ+kuri:v|me'ẽ:v chupe;ha'e:n , omanoriréma , Tetãruvicha Pyti'ajegua Tekosãsogua ; ha ary;*:n 2004- pe;*|*:n , oñeme'ẽkuri;me'ẽ+kuri:v|me'ẽ:v chupe;ha'e:n Estados Unidos Amandajevusu Pyti'ajegua Itajúgui .
martin Luther King fue;ir:v|ser:v asesinado;asesinar:v en Menphis , Estados Unidos ; el día;*:n 4 de abril;*:n del año;*:n 1968, cuando se aprestaba;aprestar:v a liderar;*:v una;uno:n|un:a|unir:v gran;grande:a manifestación;*:n en contra;*:n de la guerra;*:n de Vietnam y de la pobreza;*:n .	martin Luther King niko ojejukákuri;juka+kuri:v|juka:v Menphis , Estados Unidos - pe;*|*:n , ára;*:n 4 jasyrundy;*:n ary;*:n 1968- pe;*|*:n , oñembosako'i;mbosako'i:v|ñembosako'i:v jave;*|ja:n oho;ha:v haĝua omotenonde peteĩ;*:n ñemongu'e guasu;*:n Vietnam - me;*:n opa;*:n|pa:v haĝua ñorairõ;*:n ha ojehechakuaa;<hecha:v haĝua mboriahukuéra remikotevẽ .
tengo;tener:v un;*:a sueño;*:n , un;*:a solo;*|*:a|*:n sueño;*:n , seguir;*:v soñando;soñar:v .	areko;reko:v peteĩ;*:n kerayvoty;*:n , peteĩ;*:n kerayvoty;*:n añónte , ha'éva;'e:v|ha'e:n kerayvotyseve .
soñar;*:v con la libertad;*:n , soñar;*:v con la justicia;*:n , soñar;*:v con la igualdad;*:n y ojalá !... ya no tuviera;tener:v necesidad;*:n de soñarlas;soñar:v (las) .	che;*|*:n kerayvotýpe;kerayvoty:n oĩ;ĩ:v tekosãso , che;*|*:n kerayvotýpe;kerayvoty:n oĩ;ĩ:v tekojoja;<hekojoja:n , che;*|*:n kerayvotýpe;kerayvoty:n oĩ;ĩ:v tekopeteĩ ha nga'ura'e che;*|*:n kerayvoty;*:n amoañete .
soñar;*:v a mis hijos;hijo:n , grandes;grande:a , sanos;sano:a , felices;feliz:a , volando;volar:v con sus alas;ala:n , sin olvidar;*:v nunca el nido;*:n .	che;*|*:n kerayvotýpe;kerayvoty:n ahecha;<hecha:v che;*|*:n ñemoñarépe;ñemoña:n|moña:n|ñemoñare:n kakuaapyre;kakuaa:n , hesãi;<hesãi:n|<hesãi:v ha ivy'apavérõ ovevéramo;veve:v (ramo) ijehegui , hesarai'ỹre araka'eve haitýgui;<haity:n .
soñar;*:v con el amor;*:n , con amar;*:v y ser;*:n|*:v amado;*:a|*:n|amar:v dando;dar:v todo;*:a sin medirlo;medir:v (lo) recibiendo;recibir:v todo;*:a sin pedirlo;pedir:v (lo) .	che;*|*:n kerayvotýpe;kerayvoty:n ahecha;<hecha:v mborayhu;*:n ahecha;<hecha:v aporohayhurõ;<hayhu:v ha oĩha;ĩ:v cherayhúva;<hayhu:v añeme'ẽhápe;me'ẽ:v ha'e'ỹre;ha'e:n mboýpa ha aipyhyhápe;pyhy:v opa;*:n|pa:v mba'e;*:n ajerure'ỹre .
soñar;*:v con la paz;*:n en el mundo;*:n , en mi país;*:n ... en mí mismo;*:a , y quién sabe;saber:v cuál es;ser:v más difícil;*:a de alcanzar;*:v .	che;*|*:n kerayvotýpe;kerayvoty:n ahecha;<hecha:v py'aguapy;*:n ko yvórape , che;*|*:n retãme;<hetã:n ha … chepype;che:n ha oiménepa;ime:v|ime+pa:v oĩ;ĩ:v oikuaáva;kuaa:v umíva apytépe;*|apyte:n mávapa;máva:n|máva+pa:s hasyvéva;<hasy:v ojehupyty;<hupyty:v .
soñar;*:v que mis cabellos;cabello:n , que ralean;ralear:v y se blanquean;blanquear:v , no impiden;impedir:v que mi mente;*:n y mi corazón;*:n sigan;seguir:v jóvenes;joven:n|joven:a , y se animen;animar:v a la aventura;*:n , sigan;seguir:v niños;niño:n y conserven;conservar:v la capacidad;*:n de jugar;*:v .	che;*|*:n kerayvotýpe;kerayvoty:n ahecha;<hecha:v che;*|*:n akãrague ho'a;'a:v ho'a;'a:v ha iñapatĩ ñepyrũvo;pyrũ:n|pyrũ+vo:s ha jepémo upéicha;upe:n che;*|*:n apytu'ũ;*:n ha che;*|*:n ñe'ã;*:n akóinte ipyahu;pyahu:v ha mokõive;mokõi:n toheka;<heka:v mba'ekuaa'ỹ;mba'ekuaa:n apo;*:n|po:v katui taimitã;mitã:v ha ani ogue;gue:v chuguikuéra;ha'e:n ñembosarái;*:n|mbosarái:n reko;<heko:n .
soñar;*:v que tendré;tener:v la fuerza;*:n|forzar:v , la voluntad;*:n y el coraje;*:n para ayudar;*:v a concretar;*:v mis sueños;sueño:n en lugar;*:n de pedir;*:v por milagros;milagro:n que no merecería;merecer:v .	che;*|*:n kerayvotýpe;kerayvoty:n ahecha;<hecha:v ikatutaha chepu'aka;pu'aka:v , chekyre'ỹ;kyre'ỹ:v ha chepy'aguasu;py'aguasu:v amoañete haĝua umi che;*|*:n kerayvoty;*:n tekotevẽ'ỹre;<hekotevẽ:n ahupyty;<hupyty:v umi mba'e;*:n po'a;*:n|'a:v pytyvõ rupive;<hupi:n .
soñar;*:v que cuando llegue;llegar:v al final;*:a|*:n podré;poder:v decir;*:v que viví;vivir:v soñando;soñar:v y que mi vida;*:n fue;ir:v|ser:v un;*:a sueño;*:n soñado;soñar:v en una;uno:n|un:a|unir:v larga;largo:a|*:n|largar:v y plácida;plácido:a noche;*:n de la eternidad;*:n .	che;*|*:n kerayvotýpe;kerayvoty:n ahecha;<hecha:v ku aĝuahẽvo;guahẽ:v (vo) che;*|*:n rekove;<heko:n|<hekove:n pahápe;pa:n|paha:n ikatutaha ha'e;*|'e:v|*:n tapiaite aikohague;ko:v|iko:v kerayvoty;*:n pópe;po:n ha che;*|*:n rekove;<heko:n|<hekove:n ha'ehague;'e:v peteĩ;*:n kerayvoty;*:n kepeguare ojehúva;jehu:v peteĩ;*:n pyhare;py:n|*:n puku ha hekororývape Ko arapy;*:n ijapyra'ỹvape .
